Tournament,Date,Team_1,Team_2,Score_1,Score_2,Game_Rank_Diff_USAU,Game_Wght_USAU,Is_Ignored_USAU,Team_Rank_Diff_USAU,Game_Rank_Diff_Windmill,Game_Wght_Windmill,Is_Ignored_Windmill,Team_Rank_Diff_Windmill,Game_Rank_Diff_Sigmoid,Game_Wght_Sigmoid,Is_Ignored_Sigmoid,Team_Rank_Diff_Sigmoid
Spring Invite Padova,2023-04-21,DISConnection,FlyHigh,13,7,557.5316737222639,1.0,0,694.55,6,1,0,8.66,6,1,0,9.000027066578738
Spring Invite Padova,2023-04-21,DISConnection,Gentle Mixed,15,9,515.4814780292847,1.0,0,514.28,6,1,0,6.08,6,1,0,6.8078880051673
Spring Invite Padova,2023-04-21,DISConnection,HoneyMoon,15,6,600.0,1.0,1,1025.75,9,1,0,17.02,9,1,0,11.683690594957728
Spring Invite Padova,2023-04-21,DISConnection,Leamington Lemmings,13,12,125.0,1.0,0,74.99000000000001,1,1,0,-2.75,1,1,0,-0.7112163116669681
Spring Invite Padova,2023-04-21,DISConnection,Owls UC,15,6,600.0,1.0,1,879.54,9,1,0,12.77,9,1,0,9.988164176457875
Spring Invite Padova,2023-04-21,DISConnection,ZomBees,14,8,536.0348119187572,1.0,0,773.4,6,1,0,9.469999999999999,6,1,0,9.700015608486606
Spring Invite Padova,2023-04-21,FlyHigh,HoneyMoon,15,7,600.0,1.0,0,331.19999999999993,8,1,0,8.36,8,1,0,5.038315287108851
Spring Invite Padova,2023-04-21,FlyHigh,HoneyMoon,13,8,496.1596377856195,1.0,0,331.19999999999993,5,1,0,8.36,5,1,0,5.038315287108851
Spring Invite Padova,2023-04-21,FlyHigh,ZomBees,15,7,600.0,1.0,0,78.84999999999997,8,1,0,0.8099999999999996,8,1,0,1.143775474921238
Spring Invite Padova,2023-04-21,FucZH,FlyHigh,15,9,515.4814780292847,1.0,0,234.44,6,1,0,2.98,6,1,0,3.2062842722164007
Spring Invite Padova,2023-04-21,FucZH,Gentle Mixed,14,8,536.0348119187572,1.0,0,54.17,6,1,0,0.3999999999999999,6,1,0,0.20248769902174146
Spring Invite Padova,2023-04-21,FucZH,Owls UC,11,7,466.8933257329327,0.9733285267845752,0,419.43,4,1,0,7.09,4,1,0,4.740714291055202
Spring Invite Padova,2023-04-21,Gentle Mixed,FucZH,10,9,125.0,1.0,0,-54.17,1,1,0,-0.3999999999999999,1,1,0,-0.2024876990217397
Spring Invite Padova,2023-04-21,Gentle Mixed,Owls UC,12,8,441.15462425988915,1.0,0,365.26,4,1,0,6.6899999999999995,4,1,0,4.557671366781939
Spring Invite Padova,2023-04-21,Gentle Mixed,ZomBees,15,6,600.0,1.0,0,259.12,9,1,0,3.3899999999999997,9,1,0,4.0935762084469935
Spring Invite Padova,2023-04-21,HoneyMoon,ZomBees,11,9,249.2068104043629,1.0,0,-252.34999999999997,2,1,0,-7.55,2,1,0,-3.996908662800365
Spring Invite Padova,2023-04-21,Leamington Lemmings,FucZH,15,5,600.0,1.0,0,385.12,10,1,0,8.43,10,1,0,7.2059520255532235
Spring Invite Padova,2023-04-21,Leamington Lemmings,FucZH,15,3,600.0,1.0,0,385.12,12,1,0,8.43,12,1,0,7.2059520255532235
Spring Invite Padova,2023-04-21,Leamington Lemmings,Gentle Mixed,15,10,453.6039151898044,1.0,0,439.28999999999996,5,1,0,8.83,5,1,0,7.360705820658307
Spring Invite Padova,2023-04-21,Leamington Lemmings,HoneyMoon,15,1,600.0,1.0,0,950.76,14,1,0,19.77,14,1,0,11.953445891081742
Spring Invite Padova,2023-04-21,Leamington Lemmings,Owls UC,15,6,600.0,1.0,0,804.55,9,1,0,15.52,9,1,0,10.371916260389131
Spring Invite Padova,2023-04-21,Owls UC,HoneyMoon,15,8,564.8086448756737,1.0,0,146.20999999999992,7,1,0,4.25,7,1,0,3.522516921131448
Spring Invite Padova,2023-04-21,ZomBees,FlyHigh,15,14,125.0,1.0,0,-78.84999999999997,1,1,0,-0.8099999999999996,1,1,0,-1.1437754749212363
Spring Invite Padova,2023-04-21,ZomBees,Owls UC,10,9,125.0,1.0,0,106.14000000000004,1,1,0,3.3,1,1,0,0.5060578707415448
Spring Invite Wroclaw,2023-04-21,FRuBB,Hässliche Erdferkel,11,5,600.0,0.9176629354822471,0,219.7,6,1,0,3.86,6,1,0,3.1439579880233026
Spring Invite Wroclaw,2023-04-21,FRuBB,KS FLOW WROCŁAW,11,10,125.0,1.0,0,82.47999999999999,1,1,0,2.51,1,1,0,1.5172930643340123
Spring Invite Wroclaw,2023-04-21,FRuBB,KS FLOW WROCŁAW,13,6,600.0,1.0,0,82.47999999999999,7,1,0,2.51,7,1,0,1.5172930643340123
Spring Invite Wroclaw,2023-04-21,FRuBB,PELT,12,11,125.0,1.0,0,38.93999999999998,1,1,0,0.06999999999999984,1,1,0,1.1310987889472948
Spring Invite Wroclaw,2023-04-21,FRuBB,Zoom Ultimate,13,5,600.0,1.0,0,323.25,8,1,0,2.56,8,1,0,4.078300502428085
Spring Invite Wroclaw,2023-04-21,Hässliche Erdferkel,PELT,10,8,262.66557693448596,0.9733285267845752,0,-180.76,2,1,0,-3.79,2,1,0,-2.045183340615152
Spring Invite Wroclaw,2023-04-21,Hässliche Erdferkel,Prague Devils,9,6,418.5661446562001,0.8885233166386386,0,326.91,3,1,0,-2.14,3,1,0,2.8566912499473
Spring Invite Wroclaw,2023-04-21,Hässliche Erdferkel,Savage Ultimate,12,9,345.3654772346762,1.0,0,-111.26,3,1,0,-0.32000000000000006,3,1,0,-1.0729146127697486
Spring Invite Wroclaw,2023-04-21,Hässliche Erdferkel,Transylvania Ultimate,10,9,125.0,1.0,0,446.72999999999996,1,1,0,5.0600000000000005,1,1,0,4.399869315748678
Spring Invite Wroclaw,2023-04-21,KS FLOW WROCŁAW,Left Overs,7,6,125.0,0.8271701918685112,0,-212.28,1,1,0,-2.12,1,1,0,-2.0157330523699013
Spring Invite Wroclaw,2023-04-21,KS FLOW WROCŁAW,RJP,10,9,125.0,1.0,0,184.35,1,1,0,4.03,1,1,0,2.0554871593544206
Spring Invite Wroclaw,2023-04-21,KS FLOW WROCŁAW,Zoom Ultimate,10,9,125.0,1.0,0,240.77,1,1,0,0.04999999999999999,1,1,0,2.6334324131108815
Spring Invite Wroclaw,2023-04-21,Left Overs,FRuBB,11,9,249.2068104043629,1.0,0,129.8,2,1,0,-0.3899999999999999,2,1,0,0.5053087231270208
Spring Invite Wroclaw,2023-04-21,Left Overs,PELT,11,9,249.2068104043629,1.0,0,168.74,2,1,0,-0.32000000000000006,2,1,0,1.6322611763287718
Spring Invite Wroclaw,2023-04-21,Left Overs,RJP,9,6,418.5661446562001,0.8885233166386386,0,396.63,3,1,0,6.15,3,1,0,3.9976054025875705
Spring Invite Wroclaw,2023-04-21,Left Overs,Transylvania Ultimate,9,3,600.0,0.8271701918685112,1,796.23,6,1,0,8.53,6,1,0,7.492615954801845
Spring Invite Wroclaw,2023-04-21,Left Overs,Zoom Ultimate,11,6,546.6949863040446,0.9459053029269173,0,453.05,5,1,0,2.17,5,1,0,4.542008448962267
Spring Invite Wroclaw,2023-04-21,PELT,KS FLOW WROCŁAW,8,6,300.4922431832018,0.8583950752789521,0,43.540000000000006,2,1,0,2.44,2,1,0,0.3891626495543523
Spring Invite Wroclaw,2023-04-21,PELT,Left Overs,9,8,125.0,0.9459053029269173,0,-168.74,1,1,0,0.32000000000000006,1,1,0,-1.63226117632877
Spring Invite Wroclaw,2023-04-21,PELT,Zoom Ultimate,10,7,389.6652919127421,0.9459053029269173,0,284.31,3,1,0,2.49,3,1,0,3.008890122657423
Spring Invite Wroclaw,2023-04-21,Prague Devils,Transylvania Ultimate,11,10,125.0,1.0,0,119.81999999999994,1,1,0,7.2,1,1,0,1.6344844972562136
Spring Invite Wroclaw,2023-04-21,Prague Devils,Zoom Ultimate,10,9,125.0,1.0,0,-223.36,1,1,0,0.84,1,1,0,-1.8896572799493203
Spring Invite Wroclaw,2023-04-21,RJP,Hässliche Erdferkel,10,9,125.0,1.0,0,-47.129999999999995,1,1,0,-2.68,1,1,0,-0.39965538972952075
Spring Invite Wroclaw,2023-04-21,RJP,Prague Devils,11,8,365.60925011032475,1.0,0,279.78000000000003,3,1,0,-4.82,3,1,0,2.4695669042777624
Spring Invite Wroclaw,2023-04-21,RJP,Prague Devils,10,7,389.6652919127421,0.9459053029269173,0,279.78000000000003,3,1,0,-4.82,3,1,0,2.4695669042777624
Spring Invite Wroclaw,2023-04-21,RJP,Transylvania Ultimate,12,10,238.1225775586291,1.0,0,399.59999999999997,2,1,0,2.38,2,1,0,4.031722852271791
Spring Invite Wroclaw,2023-04-21,Savage Ultimate,Hässliche Erdferkel,12,10,238.1225775586291,1.0,0,111.26,2,1,0,0.32000000000000006,2,1,0,1.0729146127697469
Spring Invite Wroclaw,2023-04-21,Savage Ultimate,KS FLOW WROCŁAW,9,7,279.3368557106305,0.9176629354822471,0,-25.959999999999994,2,1,0,-1.03,2,1,0,-0.5936896989592206
Spring Invite Wroclaw,2023-04-21,Savage Ultimate,Prague Devils,12,7,520.5112660164395,1.0,0,438.17,5,1,0,-1.8199999999999998,5,1,0,3.876795537303739
Spring Invite Wroclaw,2023-04-21,Savage Ultimate,RJP,14,10,398.70186369942724,1.0,0,158.39,4,1,0,3.0,4,1,0,1.4697689748740963
Spring Invite Wroclaw,2023-04-21,Savage Ultimate,Transylvania Ultimate,12,7,520.5112660164395,1.0,0,557.99,5,1,0,5.38,5,1,0,5.3603200287831605
Spring Invite Wroclaw,2023-04-21,Zoom Ultimate,Transylvania Ultimate,12,7,520.5112660164395,1.0,0,343.17999999999995,5,1,0,6.36,5,1,0,3.476420329140531
G-Spot,2023-05-21,Antwerp Mixed,Belgium U20 Mixed @ G-Spot,9,8,125.0,0.9459053029269173,0,43.639999999999986,1,1,0,-6.09,1,1,0,0.8593081119351353
G-Spot,2023-05-21,Antwerp Mixed,Citadel Ultimate Frisbee @ G-Spot,13,3,600.0,1.0,0,285.53000000000003,10,1,0,-1.6100000000000003,10,1,0,5.06358374539283
G-Spot,2023-05-21,Antwerp Mixed,Friss die Frisbee @ G-Spot,11,9,249.2068104043629,1.0,0,-75.94,2,1,0,-6.15,2,1,0,-1.7337172778815315
G-Spot,2023-05-21,Antwerp Mixed,Scorillaz @ G-Spot,9,5,529.0591339672189,0.8583950752789521,0,30.139999999999986,4,1,0,-0.620000000000001,4,1,0,0.28196678133631536
G-Spot,2023-05-21,Belgian Mixed Masters @ G-Spot,Antwerp Mixed,15,6,600.0,1.0,0,730.3399999999999,9,1,0,14.370000000000001,9,1,0,10.046749372231162
G-Spot,2023-05-21,Belgian Mixed Masters @ G-Spot,Belgium Mixed @ G-Spot,9,7,279.3368557106305,0.9176629354822471,0,338.82,2,1,0,4.619999999999999,2,1,0,5.449728352163042
G-Spot,2023-05-21,Belgian Mixed Masters @ G-Spot,Bremen Ultimate,13,5,600.0,1.0,0,248.35999999999996,8,1,0,1.4399999999999995,8,1,0,4.0178027680608785
G-Spot,2023-05-21,Belgian Mixed Masters @ G-Spot,Netherlands Master Mixed @ G-Spot,14,5,600.0,1.0,0,624.92,9,1,0,12.42,9,1,0,9.228044991382557
G-Spot,2023-05-21,Belgian Mixed Masters @ G-Spot,Oxford Ultimate,14,4,600.0,1.0,0,774.71,10,1,0,12.719999999999999,10,1,0,10.279583275506475
G-Spot,2023-05-21,Belgian Mixed Masters @ G-Spot,Scorillaz @ G-Spot,15,4,600.0,1.0,0,760.48,11,1,0,13.75,11,1,0,10.200289988043078
G-Spot,2023-05-21,Belgian Mixed Masters @ G-Spot,Too Many Cooks,13,8,496.1596377856195,1.0,0,302.78,5,1,0,5.02,5,1,0,5.303314352367167
G-Spot,2023-05-21,Belgium Mixed @ G-Spot,Citadel Ultimate Frisbee @ G-Spot,15,4,600.0,1.0,0,677.0500000000001,11,1,0,8.14,11,1,0,9.799204580019381
G-Spot,2023-05-21,Belgium Mixed @ G-Spot,Jetset Simba's @ G-Spot,11,10,125.0,1.0,0,17.91,1,1,0,-0.25,1,1,0,-0.1387460428698084
G-Spot,2023-05-21,Belgium Mixed @ G-Spot,Spinners @ G-Spot,9,7,279.3368557106305,0.9176629354822471,0,-62.25,2,1,0,-2.43,2,1,0,-0.48583001025901673
G-Spot,2023-05-21,Belgium Mixed @ G-Spot,Too Many Cooks,10,9,125.0,1.0,0,-36.04,1,1,0,0.4,1,1,0,-0.16799297571244942
G-Spot,2023-05-21,Belgium Mixed @ G-Spot,ZomBees,11,8,365.60925011032475,1.0,0,435.91999999999996,3,1,0,6.33,3,1,0,5.861442192337972
G-Spot,2023-05-21,Belgium U20 Mixed @ G-Spot,AUC Mxxxd,10,5,573.8977938505714,0.8885233166386386,0,359.74000000000007,5,1,0,3.78,5,1,0,4.010143540913212
G-Spot,2023-05-21,Belgium U20 Mixed @ G-Spot,Citadel Ultimate Frisbee @ G-Spot,8,6,300.4922431832018,0.8583950752789521,0,241.89000000000004,2,1,0,4.48,2,1,0,4.287183640836869
G-Spot,2023-05-21,Belgium U20 Mixed @ G-Spot,Friss die Frisbee @ G-Spot,10,6,496.1596377856195,0.9176629354822471,0,-119.57999999999998,4,1,0,-0.06000000000000005,4,1,0,-2.57596907061855
G-Spot,2023-05-21,Belgium U20 Mixed @ G-Spot,W.underteam @ G-Spot,11,9,249.2068104043629,1.0,0,107.97999999999996,2,1,0,2.3400000000000003,2,1,0,0.7134612373974338
G-Spot,2023-05-21,Bremen Ultimate,AUC Mxxxd,11,5,600.0,0.9176629354822471,0,885.36,6,1,0,10.620000000000001,6,1,0,10.498848341799675
G-Spot,2023-05-21,Bremen Ultimate,Belgium U20 Mixed @ G-Spot,15,4,600.0,1.0,0,525.62,11,1,0,6.84,11,1,0,7.982360075446593
G-Spot,2023-05-21,Bremen Ultimate,Jetset Simba's @ G-Spot,10,9,125.0,1.0,0,108.37,1,1,0,2.93,1,1,0,1.4489677555971525
G-Spot,2023-05-21,Bremen Ultimate,Jetset Simba's @ G-Spot,11,6,546.6949863040446,0.9459053029269173,0,108.37,5,1,0,2.93,5,1,0,1.4489677555971525
G-Spot,2023-05-21,Bremen Ultimate,Spinners @ G-Spot,11,8,365.60925011032475,1.0,0,28.21,3,1,0,0.75,3,1,0,1.1042486996694123
G-Spot,2023-05-21,Bremen Ultimate,W.underteam @ G-Spot,15,3,600.0,1.0,1,633.5999999999999,12,1,0,9.18,12,1,0,8.48115004285761
G-Spot,2023-05-21,Bremen Ultimate,ZomBees,12,6,579.3107485100336,0.9733285267845752,0,526.38,6,1,0,9.51,6,1,0,7.1521792739448955
G-Spot,2023-05-21,Citadel Ultimate Frisbee @ G-Spot,AUC Mxxxd,7,6,125.0,0.8271701918685112,0,117.85000000000002,1,1,0,-0.7000000000000002,1,1,0,-0.2999600063989618
G-Spot,2023-05-21,FlyHigh,AUC Mxxxd,8,6,300.4922431832018,0.8583950752789521,0,437.83000000000004,2,1,0,1.92,2,1,0,6.013237909099143
G-Spot,2023-05-21,FlyHigh,AUC Mxxxd,9,7,279.3368557106305,0.9176629354822471,0,437.83000000000004,2,1,0,1.92,2,1,0,6.013237909099143
G-Spot,2023-05-21,Force Elektro MXD,FlyHigh,11,4,600.0,0.9176629354822471,0,322.91,7,1,0,2.45,7,1,0,3.502668500278137
G-Spot,2023-05-21,Force Elektro MXD,Free Spirits @ G-Spot,6,4,365.60925011032475,0.7254762501100116,0,125.32000000000001,2,1,0,2.2199999999999998,2,1,0,1.4155254696453987
G-Spot,2023-05-21,Force Elektro MXD,Mainzelrenner,10,9,125.0,1.0,0,-134.54000000000002,1,1,0,-2.4099999999999997,1,1,0,-0.9706417922618424
G-Spot,2023-05-21,Force Elektro MXD,Seitensprung @ G-Spot,11,5,600.0,0.9176629354822471,0,156.64999999999998,6,1,0,2.3600000000000003,6,1,0,1.8926095947966353
G-Spot,2023-05-21,Force Elektro MXD,ZomBees,11,7,466.8933257329327,0.9733285267845752,0,401.76,4,1,0,3.26,4,1,0,4.565158461320177
G-Spot,2023-05-21,Free Spirits @ G-Spot,FlyHigh,10,8,262.66557693448596,0.9733285267845752,0,197.59,2,1,0,0.23000000000000043,2,1,0,2.1341717966007003
G-Spot,2023-05-21,Free Spirits @ G-Spot,Friss die Frisbee @ G-Spot,10,9,125.0,1.0,0,156.1,1,1,0,-1.6899999999999995,1,1,0,1.798802064364164
G-Spot,2023-05-21,Free Spirits @ G-Spot,Scorillaz @ G-Spot,8,5,453.6039151898044,0.8271701918685112,0,262.17999999999995,3,1,0,3.84,3,1,0,3.749819832318316
G-Spot,2023-05-21,Free Spirits @ G-Spot,Seitensprung @ G-Spot,12,10,238.1225775586291,1.0,0,31.329999999999984,2,1,0,0.14000000000000057,2,1,0,0.48283313796335214
G-Spot,2023-05-21,Free Spirits @ G-Spot,Seitensprung @ G-Spot,9,8,125.0,0.9459053029269173,0,31.329999999999984,1,1,0,0.14000000000000057,1,1,0,0.48283313796335214
G-Spot,2023-05-21,Friss die Frisbee @ G-Spot,FlyHigh,12,10,238.1225775586291,1.0,0,41.49000000000001,2,1,0,1.92,2,1,0,0.34119113945120105
G-Spot,2023-05-21,Friss die Frisbee @ G-Spot,FlyHigh,12,8,441.15462425988915,1.0,0,41.49000000000001,4,1,0,1.92,4,1,0,0.34119113945120105
G-Spot,2023-05-21,Friss die Frisbee @ G-Spot,Force Elektro MXD,10,7,389.6652919127421,0.9459053029269173,0,-281.42,3,1,0,-0.5300000000000002,3,1,0,-3.1783591015753956
G-Spot,2023-05-21,Jetset Simba's @ G-Spot,AUC Mxxxd,15,4,600.0,1.0,0,776.99,11,1,0,7.6899999999999995,11,1,0,9.706121962544291
G-Spot,2023-05-21,Jetset Simba's @ G-Spot,Belgium U20 Mixed @ G-Spot,14,6,600.0,1.0,0,417.25,8,1,0,3.91,8,1,0,6.887443087699889
G-Spot,2023-05-21,Jetset Simba's @ G-Spot,Force Elektro MXD,11,10,125.0,1.0,0,16.250000000000004,1,1,0,3.32,1,1,0,1.6085412562436936
G-Spot,2023-05-21,Jetset Simba's @ G-Spot,Oxford Ultimate,14,5,600.0,1.0,0,417.98,9,1,0,8.35,9,1,0,6.543871826759869
G-Spot,2023-05-21,Jetset Simba's @ G-Spot,W.underteam @ G-Spot,15,6,600.0,1.0,0,525.2299999999999,9,1,0,6.25,9,1,0,7.4384510770976355
G-Spot,2023-05-21,Jetset Simba's @ G-Spot,ZomBees,11,5,600.0,0.9176629354822471,0,418.01,6,1,0,6.58,6,1,0,5.978578943018075
G-Spot,2023-05-21,Mainzelrenner,FlyHigh,12,7,520.5112660164395,1.0,0,457.45000000000005,5,1,0,4.86,5,1,0,4.40672301499831
G-Spot,2023-05-21,Mainzelrenner,Free Spirits @ G-Spot,9,7,279.3368557106305,0.9176629354822471,0,259.86,2,1,0,4.63,2,1,0,2.3716845105836377
G-Spot,2023-05-21,Mainzelrenner,Friss die Frisbee @ G-Spot,13,8,496.1596377856195,1.0,0,415.96000000000004,5,1,0,2.94,5,1,0,4.0928820568629405
G-Spot,2023-05-21,Mainzelrenner,Seitensprung @ G-Spot,11,7,466.8933257329327,0.9733285267845752,0,291.19,4,1,0,4.7700000000000005,4,1,0,2.840063268042144
G-Spot,2023-05-21,Mainzelrenner,Seitensprung @ G-Spot,9,6,418.5661446562001,0.8885233166386386,0,291.19,3,1,0,4.7700000000000005,3,1,0,2.840063268042144
G-Spot,2023-05-21,Mainzelrenner,U24 Germany Mixed @ G-Spot,10,9,125.0,1.0,0,70.51,1,1,0,-0.20000000000000007,1,1,0,0.5772148359475722
G-Spot,2023-05-21,Mainzelrenner,W.underteam @ G-Spot,13,7,557.5316737222639,1.0,0,643.52,6,1,0,5.340000000000001,6,1,0,6.943548622019222
G-Spot,2023-05-21,Netherlands Master Mixed @ G-Spot,Antwerp Mixed,12,6,579.3107485100336,0.9733285267845752,0,105.42000000000002,6,1,0,1.9500000000000002,6,1,0,1.392479167373473
G-Spot,2023-05-21,Netherlands Master Mixed @ G-Spot,Oxford Ultimate,12,5,600.0,0.9459053029269173,0,149.79000000000002,7,1,0,0.2999999999999998,7,1,0,1.8180186313810118
G-Spot,2023-05-21,Netherlands Master Mixed @ G-Spot,Oxford Ultimate,10,7,389.6652919127421,0.9459053029269173,0,149.79000000000002,3,1,0,0.2999999999999998,3,1,0,1.8180186313810118
G-Spot,2023-05-21,Netherlands Master Mixed @ G-Spot,W.underteam @ G-Spot,10,7,389.6652919127421,0.9459053029269173,0,257.03999999999996,3,1,0,-1.7999999999999998,3,1,0,2.932508508388807
G-Spot,2023-05-21,Oxford Ultimate,Antwerp Mixed,11,10,125.0,1.0,0,-44.370000000000005,1,1,0,1.6500000000000004,1,1,0,-0.4303818394159258
G-Spot,2023-05-21,Oxford Ultimate,Scorillaz @ G-Spot,13,9,418.5661446562001,1.0,0,-14.230000000000018,4,1,0,1.0299999999999994,4,1,0,-0.14849514869518998
G-Spot,2023-05-21,Oxford Ultimate,Scorillaz @ G-Spot,10,9,125.0,1.0,0,-14.230000000000018,1,1,0,1.0299999999999994,1,1,0,-0.14849514869518998
G-Spot,2023-05-21,Scorillaz @ G-Spot,Belgium U20 Mixed @ G-Spot,10,7,389.6652919127421,0.9459053029269173,0,13.5,3,1,0,-5.469999999999999,3,1,0,0.577963723916163
G-Spot,2023-05-21,Scorillaz @ G-Spot,Netherlands Master Mixed @ G-Spot,9,8,125.0,0.9459053029269173,0,-135.56,1,1,0,-1.3299999999999992,1,1,0,-1.6715290720208937
G-Spot,2023-05-21,Scorillaz @ G-Spot,W.underteam @ G-Spot,9,4,600.0,0.8271701918685112,0,121.47999999999996,5,1,0,-3.129999999999999,5,1,0,1.289062512410645
G-Spot,2023-05-21,Seitensprung @ G-Spot,Citadel Ultimate Frisbee @ G-Spot,13,4,600.0,1.0,0,486.24,9,1,0,2.71,9,1,0,7.572259561002632
G-Spot,2023-05-21,Seitensprung @ G-Spot,FlyHigh,9,5,529.0591339672189,0.8583950752789521,0,166.26000000000002,4,1,0,0.08999999999999986,4,1,0,1.6589362094594975
G-Spot,2023-05-21,Seitensprung @ G-Spot,Friss die Frisbee @ G-Spot,10,8,262.66557693448596,0.9733285267845752,0,124.77000000000001,2,1,0,-1.83,2,1,0,1.3210683750686236
G-Spot,2023-05-21,Seitensprung @ G-Spot,Netherlands Master Mixed @ G-Spot,11,6,546.6949863040446,0.9459053029269173,0,95.28999999999999,5,1,0,2.37,5,1,0,1.6626402391473967
G-Spot,2023-05-21,Spinners @ G-Spot,Citadel Ultimate Frisbee @ G-Spot,15,4,600.0,1.0,0,739.3000000000001,11,1,0,10.57,11,1,0,10.071923974675453
G-Spot,2023-05-21,Spinners @ G-Spot,Force Elektro MXD,10,8,262.66557693448596,0.9733285267845752,0,96.41,2,1,0,5.5,2,1,0,1.950886994612226
G-Spot,2023-05-21,Spinners @ G-Spot,Mainzelrenner,9,8,125.0,0.9459053029269173,0,-38.13,1,1,0,3.0900000000000003,1,1,0,0.9885650202568517
G-Spot,2023-05-21,Spinners @ G-Spot,Too Many Cooks,12,6,579.3107485100336,0.9733285267845752,0,26.21,6,1,0,2.83,6,1,0,0.3179523679230858
G-Spot,2023-05-21,Spinners @ G-Spot,U24 Germany Mixed @ G-Spot,11,9,249.2068104043629,1.0,0,32.38,2,1,0,2.89,2,1,0,1.5618189833340992
G-Spot,2023-05-21,Too Many Cooks,Citadel Ultimate Frisbee @ G-Spot,15,4,600.0,1.0,1,713.09,11,1,0,7.74,11,1,0,9.894802888424504
G-Spot,2023-05-21,Too Many Cooks,Free Spirits @ G-Spot,8,6,300.4922431832018,0.8583950752789521,0,195.52,2,1,0,4.89,2,1,0,3.021844575262037
G-Spot,2023-05-21,Too Many Cooks,Spinners @ G-Spot,10,8,262.66557693448596,0.9733285267845752,0,-26.21,2,1,0,-2.83,2,1,0,-0.31795236792308756
G-Spot,2023-05-21,Too Many Cooks,U24 Germany Mixed @ G-Spot,9,7,279.3368557106305,0.9176629354822471,0,6.170000000000002,2,1,0,0.05999999999999994,2,1,0,1.246617951338223
G-Spot,2023-05-21,Too Many Cooks,ZomBees,12,8,441.15462425988915,1.0,0,471.96,4,1,0,5.93,4,1,0,6.003163161824382
G-Spot,2023-05-21,U24 Germany Mixed @ G-Spot,Belgium Mixed @ G-Spot,11,6,546.6949863040446,0.9459053029269173,0,29.869999999999997,5,1,0,-0.45999999999999996,5,1,0,-1.079629861796814
G-Spot,2023-05-21,U24 Germany Mixed @ G-Spot,Citadel Ultimate Frisbee @ G-Spot,9,6,418.5661446562001,0.8885233166386386,0,706.9200000000001,3,1,0,7.68,3,1,0,9.149798823611807
G-Spot,2023-05-21,U24 Germany Mixed @ G-Spot,Free Spirits @ G-Spot,9,6,418.5661446562001,0.8885233166386386,0,189.35000000000002,3,1,0,4.83,3,1,0,1.805454634249422
G-Spot,2023-05-21,U24 Germany Mixed @ G-Spot,Friss die Frisbee @ G-Spot,9,5,529.0591339672189,0.8583950752789521,0,345.45,4,1,0,3.14,4,1,0,3.5529729991273236
G-Spot,2023-05-21,U24 Germany Mixed @ G-Spot,Oxford Ultimate,10,7,389.6652919127421,0.9459053029269173,0,465.76,3,1,0,7.640000000000001,3,1,0,5.5218433695677085
G-Spot,2023-05-21,W.underteam @ G-Spot,AUC Mxxxd,8,2,600.0,0.7608859102526822,0,251.7600000000001,6,1,0,1.4399999999999995,6,1,0,3.339142572938812
G-Spot,2023-05-21,W.underteam @ G-Spot,Antwerp Mixed,10,5,573.8977938505714,0.8885233166386386,0,-151.61999999999995,5,1,0,3.75,5,1,0,-1.5684954917024108
G-Spot,2023-05-21,ZomBees,AUC Mxxxd,13,4,600.0,1.0,0,358.9800000000001,9,1,0,1.1100000000000003,9,1,0,5.023005534418367
G-Spot,2023-05-21,ZomBees,Belgium U20 Mixed @ G-Spot,9,7,279.3368557106305,0.9176629354822471,0,-0.7599999999999909,2,1,0,-2.6699999999999995,2,1,0,1.11245365657361
G-Spot,2023-05-21,ZomBees,Netherlands Master Mixed @ G-Spot,12,8,441.15462425988915,1.0,0,-149.82,4,1,0,1.4700000000000006,4,1,0,-1.140047207632847
G-Spot,2023-05-21,ZomBees,W.underteam @ G-Spot,11,8,365.60925011032475,1.0,0,107.21999999999997,3,1,0,-0.3299999999999992,3,1,0,1.8194965788515525
DFV-Pokal Mixed,2023-05-29,Bremen Ultimate,Colorado,13,8,496.1596377856195,1.0,0,156.14,5,1,0,5.51,5,1,0,2.0253061437051763
DFV-Pokal Mixed,2023-05-29,Bremen Ultimate,Maultaschen,13,7,557.5316737222639,1.0,0,424.01,6,1,0,8.43,6,1,0,5.08218188823934
DFV-Pokal Mixed,2023-05-29,Bremen Ultimate,TV Bad Rappenau,13,9,418.5661446562001,1.0,0,437.11,4,1,0,7.43,4,1,0,5.421713446048738
DFV-Pokal Mixed,2023-05-29,Colorado,Hucks Ultimate Club Berlin,15,14,125.0,1.0,0,9.560000000000002,1,1,0,2.57,1,1,0,0.2054871442001609
DFV-Pokal Mixed,2023-05-29,Colorado,Maultaschen,13,6,600.0,1.0,0,267.87,7,1,0,2.9200000000000004,7,1,0,3.2034212199755743
DFV-Pokal Mixed,2023-05-29,Colorado,TV Bad Rappenau,13,8,496.1596377856195,1.0,0,280.97,5,1,0,1.92,5,1,0,3.5706657833192494
DFV-Pokal Mixed,2023-05-29,FRuBB,Bonnsai,13,8,496.1596377856195,1.0,0,658.14,5,1,0,12.2,5,1,0,9.206572023910681
DFV-Pokal Mixed,2023-05-29,FRuBB,Colorado,15,11,381.1647521399218,1.0,0,211.85999999999999,4,1,0,3.65,4,1,0,2.520614236552017
DFV-Pokal Mixed,2023-05-29,FRuBB,Hucks Ultimate Club Berlin,13,4,600.0,1.0,0,221.42,9,1,0,6.22,9,1,0,2.7198402622782822
DFV-Pokal Mixed,2023-05-29,FRuBB,Maultaschen,15,11,381.1647521399218,1.0,0,479.72999999999996,4,1,0,6.57,4,1,0,5.525733124794673
DFV-Pokal Mixed,2023-05-29,Hucks Ultimate Club Berlin,Bonnsai,13,3,600.0,1.0,0,436.72,10,1,0,5.9799999999999995,10,1,0,7.299047831762582
DFV-Pokal Mixed,2023-05-29,Hucks Ultimate Club Berlin,Maultaschen,15,10,453.6039151898044,1.0,0,258.30999999999995,5,1,0,0.35000000000000053,5,1,0,3.0067305918934153
DFV-Pokal Mixed,2023-05-29,Maultaschen,TV Bad Rappenau,13,9,418.5661446562001,1.0,0,13.100000000000023,4,1,0,-1.0000000000000004,4,1,0,0.386914155296596
DFV-Pokal Mixed,2023-05-29,Nullacht! Ultimate,Bonnsai,13,3,600.0,1.0,1,719.4,10,1,0,18.2,10,1,0,9.807367965241642
DFV-Pokal Mixed,2023-05-29,Nullacht! Ultimate,Bremen Ultimate,15,10,453.6039151898044,1.0,0,116.98,5,1,0,4.14,5,1,0,1.5068997650978204
DFV-Pokal Mixed,2023-05-29,Nullacht! Ultimate,FRuBB,13,12,125.0,1.0,0,61.26000000000002,1,1,0,6.0,1,1,0,1.0034988803528293
DFV-Pokal Mixed,2023-05-29,Nullacht! Ultimate,Hucks Ultimate Club Berlin,13,12,125.0,1.0,0,282.68,1,1,0,12.219999999999999,1,1,0,3.6787145908042085
DFV-Pokal Mixed,2023-05-29,TV Bad Rappenau,Bonnsai,14,8,536.0348119187572,1.0,0,165.31,6,1,0,6.629999999999999,6,1,0,4.405352436122676
DFV-Pokal Mixed,2023-05-29,Tiefseetaucher,Bremen Ultimate,13,7,557.5316737222639,1.0,0,290.4,6,1,0,3.3899999999999997,6,1,0,3.5296024843917806
DFV-Pokal Mixed,2023-05-29,Tiefseetaucher,Colorado,13,6,600.0,1.0,0,446.53999999999996,7,1,0,8.9,7,1,0,5.383856899846663
DFV-Pokal Mixed,2023-05-29,Tiefseetaucher,Maultaschen,13,7,557.5316737222639,1.0,0,714.41,6,1,0,11.82,6,1,0,7.975906738601623
DFV-Pokal Mixed,2023-05-29,Tiefseetaucher,Nullacht! Ultimate,15,9,515.4814780292847,1.0,0,173.42,6,1,0,-0.75,6,1,0,2.071674877410725
DFV-Pokal Mixed,2023-05-29,Tiefseetaucher,TV Bad Rappenau,13,8,496.1596377856195,1.0,0,727.51,5,1,0,10.82,5,1,0,8.249672376084792
DFV-Pokal Mixed,2023-05-29,Zamperl,Bonnsai,13,4,600.0,1.0,0,971.99,9,1,0,17.0,9,1,0,11.374482710327083
DFV-Pokal Mixed,2023-05-29,Zamperl,Bremen Ultimate,15,10,453.6039151898044,1.0,0,369.57,5,1,0,2.9399999999999995,5,1,0,4.52088029978929
DFV-Pokal Mixed,2023-05-29,Zamperl,FRuBB,13,11,228.8403622143806,1.0,0,313.85,2,1,0,4.8,2,1,0,4.05536981508066
DFV-Pokal Mixed,2023-05-29,Zamperl,Hucks Ultimate Club Berlin,13,7,557.5316737222639,1.0,0,535.27,6,1,0,11.02,6,1,0,6.458596525913524
DFV-Pokal Mixed,2023-05-29,Zamperl,Nullacht! Ultimate,13,11,228.8403622143806,1.0,0,252.59,2,1,0,-1.2000000000000002,2,1,0,3.108086678411844
DFV-Pokal Mixed,2023-05-29,Zamperl,Tiefseetaucher,15,10,453.6039151898044,1.0,0,79.17000000000002,5,1,0,-0.4500000000000002,5,1,0,1.0669451395156173
Elite Invite,2023-05-29,DISConnection,Deep Space,14,13,125.0,1.0,0,-114.91000000000003,1,1,0,-3.4799999999999995,1,1,0,-1.53139590025412
Elite Invite,2023-05-29,DISConnection,PUC,15,5,600.0,1.0,0,354.23,10,1,0,2.83,10,1,0,4.900105131682174
Elite Invite,2023-05-29,DISConnection,Reading,12,9,345.3654772346762,1.0,0,-72.94,3,1,0,-0.3899999999999997,3,1,0,-1.538817348349717
Elite Invite,2023-05-29,DISConnection,Smog,15,12,300.4922431832018,1.0,0,215.93,3,1,0,3.0700000000000003,3,1,0,2.7597140651682004
Elite Invite,2023-05-29,Deep Space,Mosquitos,15,4,600.0,1.0,0,401.47,11,1,0,6.64,11,1,0,5.985516829872822
Elite Invite,2023-05-29,Deep Space,PUC,15,9,515.4814780292847,1.0,0,469.14000000000004,6,1,0,6.31,6,1,0,6.223926154066934
Elite Invite,2023-05-29,Deep Space,Sesquidistus,13,10,328.14240231865136,1.0,0,161.06,3,1,0,2.9699999999999998,3,1,0,2.2853173998000464
Elite Invite,2023-05-29,GRUT,Deep Space,15,8,564.8086448756737,1.0,0,176.84000000000003,7,1,0,1.9400000000000004,7,1,0,2.3899621480467523
Elite Invite,2023-05-29,GRUT,Deep Space,13,11,228.8403622143806,1.0,0,176.84000000000003,2,1,0,1.9400000000000004,2,1,0,2.3899621480467523
Elite Invite,2023-05-29,GRUT,PUC,15,6,600.0,1.0,1,645.98,9,1,0,8.25,9,1,0,8.079730229345401
Elite Invite,2023-05-29,GRUT,Smog,12,9,345.3654772346762,1.0,0,507.68000000000006,3,1,0,8.49,3,1,0,6.319234639590864
Elite Invite,2023-05-29,Mosquitos,GRUT,13,11,228.8403622143806,1.0,0,-578.3100000000001,2,1,0,-8.58,2,1,0,-7.874810474563085
Elite Invite,2023-05-29,Mosquitos,PUC,15,11,381.1647521399218,1.0,0,67.67,4,1,0,-0.33000000000000007,4,1,0,0.2857154385538401
Elite Invite,2023-05-29,Mosquitos,PUC,12,10,238.1225775586291,1.0,0,67.67,2,1,0,-0.33000000000000007,2,1,0,0.2857154385538401
Elite Invite,2023-05-29,Reading,DISConnection,14,11,313.3379659704299,1.0,0,72.94,3,1,0,0.3899999999999997,3,1,0,1.538817348349717
Elite Invite,2023-05-29,Reading,GRUT,15,10,453.6039151898044,1.0,0,-218.81000000000006,5,1,0,-5.03,5,1,0,-2.382651963589433
Elite Invite,2023-05-29,Reading,Mosquitos,15,9,515.4814780292847,1.0,0,359.5,6,1,0,3.55,6,1,0,5.991821357761495
Elite Invite,2023-05-29,Reading,Sesquidistus,15,10,453.6039151898044,1.0,0,119.08999999999997,5,1,0,-0.1200000000000001,5,1,0,2.29264275197718
Elite Invite,2023-05-29,Reading,Smog,15,5,600.0,1.0,0,288.87,10,1,0,3.46,10,1,0,4.218902978422623
Elite Invite,2023-05-29,Sesquidistus,DISConnection,14,13,125.0,1.0,0,-46.14999999999998,1,1,0,0.5099999999999998,1,1,0,-0.7658335319515608
Elite Invite,2023-05-29,Sesquidistus,PUC,15,8,564.8086448756737,1.0,0,308.08000000000004,7,1,0,3.34,7,1,0,4.204394639069001
Elite Invite,2023-05-29,Sesquidistus,Smog,15,7,600.0,1.0,0,169.78000000000003,8,1,0,3.58,8,1,0,2.0127871489636284
Elite Invite,2023-05-29,Sesquidistus,Smog,13,7,557.5316737222639,1.0,0,169.78000000000003,6,1,0,3.58,6,1,0,2.0127871489636284
Elite Invite,2023-05-29,Smog,Mosquitos,15,12,300.4922431832018,1.0,0,70.63,3,1,0,0.09000000000000008,3,1,0,1.9973185670484241
EUCR Istanbul,2023-06-11,Fireball Ultimate,OldSchool,9,7,279.3368557106305,0.9176629354822471,0,84.81,2,1,0,-2.35,2,1,0,0.7920127410702236
EUCR Istanbul,2023-06-11,Fireball Ultimate,Shopski Otryad,9,4,600.0,0.8271701918685112,0,99.90999999999997,5,1,0,-1.9300000000000002,5,1,0,0.0922488369757204
EUCR Istanbul,2023-06-11,Fireball Ultimate,Steamhuck,10,9,125.0,1.0,0,-33.09,1,1,0,1.1099999999999999,1,1,0,0.2842159799247934
EUCR Istanbul,2023-06-11,Fireball Ultimate,Transylvania Ultimate,8,7,125.0,0.8885233166386386,0,322.67999999999995,1,1,0,4.46,1,1,0,3.063554658369924
EUCR Istanbul,2023-06-11,OldSchool,Seahawks Ultimate,12,11,125.0,1.0,0,361.77000000000004,1,1,0,10.15,1,1,0,3.925744165689167
EUCR Istanbul,2023-06-11,OldSchool,Shopski Otryad,11,7,466.8933257329327,0.9733285267845752,0,15.099999999999966,4,1,0,0.42000000000000004,4,1,0,-0.6999912060298623
EUCR Istanbul,2023-06-11,OldSchool,Steamhuck,11,10,125.0,1.0,0,-117.9,1,1,0,3.46,1,1,0,-0.5083052984057179
EUCR Istanbul,2023-06-11,Seahawks Ultimate,Transylvania Ultimate,10,9,125.0,1.0,0,-123.90000000000009,1,1,0,-3.34,1,1,0,-1.697448023294731
EUCR Istanbul,2023-06-11,Shopski Otryad,Seahawks Ultimate,15,5,600.0,1.0,0,346.6700000000001,10,1,0,9.73,10,1,0,4.569921671405346
EUCR Istanbul,2023-06-11,Shopski Otryad,Steamhuck,12,11,125.0,1.0,0,-132.99999999999997,1,1,0,3.04,1,1,0,0.19198951492714933
EUCR Istanbul,2023-06-11,Shopski Otryad,Transylvania Ultimate,15,8,564.8086448756737,1.0,0,222.76999999999998,7,1,0,6.39,7,1,0,2.975042598583716
EUCR Istanbul,2023-06-11,Steamhuck,Fireball Ultimate,8,6,300.4922431832018,0.8583950752789521,0,33.09,2,1,0,-1.1099999999999999,2,1,0,-0.2842159799247952
EUCR Istanbul,2023-06-11,Steamhuck,OldSchool,11,8,365.60925011032475,1.0,0,117.9,3,1,0,-3.46,3,1,0,0.5083052984057197
EUCR Istanbul,2023-06-11,Transylvania Ultimate,Seahawks Ultimate,11,7,466.8933257329327,0.9733285267845752,0,123.90000000000009,4,1,0,3.34,4,1,0,1.6974480232947329
EUCR Istanbul,2023-06-11,Zoom Ultimate,Fireball Ultimate,11,8,365.60925011032475,1.0,0,20.5,3,1,0,1.9000000000000001,3,1,0,0.4333793524612535
EUCR Istanbul,2023-06-11,Zoom Ultimate,OldSchool,10,9,125.0,1.0,0,105.31,1,1,0,-0.45,1,1,0,1.2235255809565153
EUCR Istanbul,2023-06-11,Zoom Ultimate,Seahawks Ultimate,11,8,365.60925011032475,1.0,0,467.08000000000004,3,1,0,9.7,3,1,0,5.041641930679354
EUCR Istanbul,2023-06-11,Zoom Ultimate,Transylvania Ultimate,13,6,600.0,1.0,0,343.17999999999995,7,1,0,6.36,7,1,0,3.476420329140531
Windmill,2023-06-16,Austria Mixed @ Windmill,DTU,15,0,600.0,1.0,0,834.06,15,1,0,13.36,15,1,0,11.397369208496233
Windmill,2023-06-16,Austria Mixed @ Windmill,Denmark Mixed @ Windmill,14,4,600.0,1.0,0,149.89000000000001,10,1,0,4.68,10,1,0,4.558352115211655
Windmill,2023-06-16,Belgium Mixed @ Windmill,DTU,15,5,600.0,1.0,0,643.5699999999999,10,1,0,10.48,10,1,0,8.617861300485458
Windmill,2023-06-16,Chang Chi and the Legend of 20ish Rings @ Windmill,Disckatus Ultimate Madrid @ Windmill,11,5,600.0,0.9176629354822471,0,653.6,6,1,0,6.32,6,1,0,9.310103556896241
Windmill,2023-06-16,Chang Chi and the Legend of 20ish Rings @ Windmill,Ellipsis @ Windmill,12,11,125.0,1.0,0,-35.51999999999998,1,1,0,-4.119999999999999,1,1,0,-0.22573295723096365
Windmill,2023-06-16,Czech Republic Mixed @ Windmill,Belgium Mixed @ Windmill,11,11,0.0,1.0,0,126.30000000000001,0,1,0,-0.04999999999999982,0,1,0,1.3463667712074034
Windmill,2023-06-16,DISConnection,Kingdom of Raptors @ Windmill,15,4,600.0,1.0,0,571.4,11,1,0,7.96,11,1,0,8.026347581929706
Windmill,2023-06-16,DISConnection,PUC,15,9,515.4814780292847,1.0,0,354.23,6,1,0,2.83,6,1,0,4.900105131682174
Windmill,2023-06-16,DTU,Kingdom of Raptors @ Windmill,11,10,125.0,1.0,0,-224.85999999999999,1,1,0,-2.29,1,1,0,-3.1690455720299973
Windmill,2023-06-16,Deep Space,Disckatus Ultimate Madrid @ Windmill,15,3,600.0,1.0,0,574.11,12,1,0,5.41,12,1,0,7.870463232296306
Windmill,2023-06-16,Deep Space,Too Many Cooks,15,9,515.4814780292847,1.0,0,416.35,6,1,0,7.02,6,1,0,6.3050392775818445
Windmill,2023-06-16,Disckatus Ultimate Madrid @ Windmill,Rainbow Brigade @ Windmill,12,10,238.1225775586291,1.0,0,201.76999999999998,2,1,0,5.87,2,1,0,2.764786031186823
Windmill,2023-06-16,Ellipsis @ Windmill,Estonia Mixed @ Windmill,12,11,125.0,1.0,0,126.69,1,1,0,8.059999999999999,1,1,0,1.526200435531699
Windmill,2023-06-16,Ellipsis @ Windmill,Pampered cats @ Windmill,15,7,600.0,1.0,0,505.6,8,1,0,13.78,8,1,0,7.935480090383091
Windmill,2023-06-16,Estonia Mixed @ Windmill,Frizstyle FBF,15,7,600.0,1.0,0,238.95000000000002,8,1,0,3.16,8,1,0,3.8487850350040986
Windmill,2023-06-16,EuroTrash @ Windmill,New Age Mix,11,8,365.60925011032475,1.0,0,44.140000000000015,3,1,0,0.7899999999999991,3,1,0,0.13799610669181206
Windmill,2023-06-16,EuroTrash @ Windmill,Rainbow Brigade @ Windmill,14,7,582.8868714046324,1.0,0,467.64,7,1,0,8.66,7,1,0,6.806696933373985
Windmill,2023-06-16,FRuBB,Denmark Mixed @ Windmill,12,12,0.0,1.0,0,-79.21000000000001,0,1,0,-0.25,0,1,0,-1.3039504492051908
Windmill,2023-06-16,FRuBB,New Age Mix,11,8,365.60925011032475,1.0,0,46.16999999999999,3,1,0,-1.8900000000000006,3,1,0,-0.4551102711433561
Windmill,2023-06-16,Farmer Brown's Greenhouse (FBG) @ Windmill,Frizstyle FBF,14,12,220.95664314305532,1.0,0,274.17999999999995,2,1,0,5.33,2,1,0,3.2892055062803394
Windmill,2023-06-16,Farmer Brown's Greenhouse (FBG) @ Windmill,HORANGI,14,8,536.0348119187572,1.0,0,481.71999999999997,6,1,0,6.5,6,1,0,5.713987750051253
Windmill,2023-06-16,Farmer Brown's Greenhouse (FBG) @ Windmill,Switzerland Mixed @ Windmill,13,10,328.14240231865136,1.0,0,299.62,3,1,0,5.86,3,1,0,3.603899685138746
Windmill,2023-06-16,Finland Mixed @ Windmill,Fusion Falcons Ultimate Club,13,10,328.14240231865136,1.0,0,653.38,3,1,0,8.75,3,1,0,8.086116882858345
Windmill,2023-06-16,Finland Mixed @ Windmill,NOISE Ultimate @ Windmill,11,9,249.2068104043629,1.0,0,20.83000000000004,2,1,0,-2.96,2,1,0,-1.063960275385341
Windmill,2023-06-16,Force Elektro MXD,Fusion Falcons Ultimate Club,13,7,557.5316737222639,1.0,0,223.26,6,1,0,1.5,6,1,0,2.9872889812892076
Windmill,2023-06-16,Force Elektro MXD,Norway Mixed @ Windmill,9,5,529.0591339672189,0.8583950752789521,0,292.58,4,1,0,3.6400000000000006,4,1,0,3.5303109490768705
Windmill,2023-06-16,France Mixed @ Windmill,Austria Mixed @ Windmill,15,6,600.0,1.0,0,363.56999999999994,9,1,0,4.48,9,1,0,4.54950077293865
Windmill,2023-06-16,France Mixed @ Windmill,Great Britain Mixed @ Windmill,14,10,398.70186369942724,1.0,0,-150.68000000000006,4,1,0,-0.8900000000000006,4,1,0,-1.2510867586599161
Windmill,2023-06-16,France Mixed @ Windmill,Smog,15,5,600.0,1.0,0,617.3,10,1,0,10.66,10,1,0,8.9049083091592
Windmill,2023-06-16,GRUT,Deep Space,14,5,600.0,1.0,0,176.84000000000003,9,1,0,1.9400000000000004,9,1,0,2.3899621480467523
Windmill,2023-06-16,GRUT,EuroTrash @ Windmill,12,10,238.1225775586291,1.0,0,485.08000000000004,2,1,0,4.5600000000000005,2,1,0,6.210882083861538
Windmill,2023-06-16,GRUT,FRuBB,14,9,473.8676990361691,1.0,0,483.05000000000007,5,1,0,7.24,5,1,0,6.694254790309916
Windmill,2023-06-16,Germany Mixed @ Windmill,Fusion Falcons Ultimate Club,15,3,600.0,1.0,0,1144.25,12,1,0,21.11,12,1,0,13.020329715263436
Windmill,2023-06-16,Germany Mixed @ Windmill,Ireland Mixed @ Windmill,15,9,515.4814780292847,1.0,0,164.68999999999994,6,1,0,7.859999999999999,6,1,0,3.6356842353117003
Windmill,2023-06-16,Germany Mixed @ Windmill,Poland Mixed @ Windmill,15,6,600.0,1.0,0,355.63,9,1,0,14.469999999999999,9,1,0,6.170435726819143
Windmill,2023-06-16,Great Britain Mixed @ Windmill,Finland Mixed @ Windmill,15,2,600.0,1.0,0,493.57,13,1,0,7.44,13,1,0,8.422795973474752
Windmill,2023-06-16,Great Britain Mixed @ Windmill,Swedish Royals @ Windmill,15,9,515.4814780292847,1.0,0,412.89,6,1,0,8.56,6,1,0,5.284273368115233
Windmill,2023-06-16,HORANGI,LoL Mixed Ultimate Team,15,5,600.0,1.0,0,418.55,10,1,0,8.06,10,1,0,7.037485220284985
Windmill,2023-06-16,Ireland Mixed @ Windmill,Chang Chi and the Legend of 20ish Rings @ Windmill,14,9,473.8676990361691,1.0,0,190.26,5,1,0,1.1499999999999986,5,1,0,2.596344834267345
Windmill,2023-06-16,Ireland Mixed @ Windmill,Denmark Mixed @ Windmill,15,9,515.4814780292847,1.0,0,496.75,6,1,0,7.109999999999999,6,1,0,7.511737245983419
Windmill,2023-06-16,Italy Mixed @ Windmill,Frizstyle FBF,13,10,328.14240231865136,1.0,0,447.44999999999993,3,1,0,6.6000000000000005,3,1,0,5.895087623872051
Windmill,2023-06-16,Italy Mixed @ Windmill,NOISE Ultimate @ Windmill,13,11,228.8403622143806,1.0,0,274.08,2,1,0,-0.10999999999999943,2,1,0,4.298200855745527
Windmill,2023-06-16,Italy Mixed @ Windmill,Poland Mixed @ Windmill,11,11,0.0,1.0,0,118.00999999999999,0,1,0,4.960000000000001,0,1,0,1.2116046463945231
Windmill,2023-06-16,Lithuania Mixed @ Windmill,Belgium Mixed @ Windmill,15,5,600.0,1.0,0,154.67000000000002,10,1,0,-1.6099999999999999,10,1,0,3.3070490333293385
Windmill,2023-06-16,Lithuania Mixed @ Windmill,Estonia Mixed @ Windmill,12,11,125.0,1.0,0,-101.25,1,1,0,-1.8300000000000005,1,1,0,-1.3768633808624688
Windmill,2023-06-16,Lithuania Mixed @ Windmill,Norway Mixed @ Windmill,15,6,600.0,1.0,0,666.2,9,1,0,8.47,9,1,0,9.631598858790436
Windmill,2023-06-16,LoL Mixed Ultimate Team,Steamhuck,12,11,125.0,1.0,0,-259.85,1,1,0,-4.550000000000001,1,1,0,-3.636390166089777
Windmill,2023-06-16,NOISE Ultimate @ Windmill,PUC,11,9,249.2068104043629,1.0,0,391.88,2,1,0,6.83,2,1,0,5.12396315836839
Windmill,2023-06-16,New Age Mix,DISConnection,15,9,515.4814780292847,1.0,0,-237.47,6,1,0,0.07000000000000028,6,1,0,-2.7662350441952643
Windmill,2023-06-16,PUC,Czech Republic Mixed @ Windmill,11,10,125.0,1.0,0,-327.84000000000003,1,1,0,-3.01,1,1,0,-3.976695144069497
Windmill,2023-06-16,Pampered cats @ Windmill,Czech Republic Mixed @ Windmill,11,10,125.0,1.0,0,-249.29000000000002,1,1,0,-5.45,1,1,0,-3.8214471003484647
Windmill,2023-06-16,Pampered cats @ Windmill,Rainbow Brigade @ Windmill,13,7,557.5316737222639,1.0,0,385.28999999999996,6,1,0,2.5300000000000002,6,1,0,4.89608495842338
Windmill,2023-06-16,Poland Mixed @ Windmill,Steamhuck,15,4,600.0,1.0,0,695.68,11,1,0,6.32,11,1,0,9.74134309066141
Windmill,2023-06-16,Smog,Force Elektro MXD,15,6,600.0,1.0,0,155.71,9,1,0,3.1399999999999997,9,1,0,3.942505976056804
Windmill,2023-06-16,Swedish Royals @ Windmill,LoL Mixed Ultimate Team,15,3,600.0,1.0,0,900.97,12,1,0,11.86,12,1,0,11.44746850972642
Windmill,2023-06-16,Swedish Royals @ Windmill,Smog,11,10,125.0,1.0,0,355.09000000000003,1,1,0,2.99,1,1,0,5.684468219308847
Windmill,2023-06-16,Switzerland Mixed @ Windmill,Kingdom of Raptors @ Windmill,15,8,564.8086448756737,1.0,0,410.24,7,1,0,4.72,7,1,0,6.589341661805822
Windmill,2023-06-16,Switzerland Mixed @ Windmill,Norway Mixed @ Windmill,15,2,600.0,1.0,0,503.05999999999995,13,1,0,6.61,13,1,0,7.721572679288862
Windmill,2023-06-16,Too Many Cooks,HORANGI,12,11,125.0,1.0,0,41.82,1,1,0,0.33999999999999997,1,1,0,-0.9534627525958861
Windmill,2023-06-16,Too Many Cooks,Steamhuck,15,10,453.6039151898044,1.0,0,200.52,5,1,0,3.85,5,1,0,2.9317871666921143
Windmill,2023-06-17,Austria Mixed @ Windmill,Estonia Mixed @ Windmill,10,3,600.0,0.8583950752789521,0,-65.43,7,1,0,2.6599999999999993,7,1,0,0.38016856852993897
Windmill,2023-06-17,Belgium Mixed @ Windmill,HORANGI,14,10,398.70186369942724,1.0,0,190.57,4,1,0,4.109999999999999,4,1,0,1.8579105455659999
Windmill,2023-06-17,Belgium Mixed @ Windmill,New Age Mix,15,11,381.1647521399218,1.0,0,84.78,4,1,0,0.15999999999999925,4,1,0,0.43562746452490586
Windmill,2023-06-17,Belgium Mixed @ Windmill,PUC,13,10,328.14240231865136,1.0,0,201.54,3,1,0,3.0599999999999996,3,1,0,2.6944452752891515
Windmill,2023-06-17,Chang Chi and the Legend of 20ish Rings @ Windmill,Lithuania Mixed @ Windmill,15,6,600.0,1.0,0,192.42000000000002,9,1,0,5.770000000000001,9,1,0,2.658139052628986
Windmill,2023-06-17,Chang Chi and the Legend of 20ish Rings @ Windmill,Poland Mixed @ Windmill,12,11,125.0,1.0,0,0.6800000000000637,1,1,0,5.460000000000001,1,1,0,0.22648278681491085
Windmill,2023-06-17,Czech Republic Mixed @ Windmill,Force Elektro MXD,13,4,600.0,1.0,0,345.25,9,1,0,6.39,9,1,0,5.5412835450073885
Windmill,2023-06-17,Czech Republic Mixed @ Windmill,Fusion Falcons Ultimate Club,13,8,496.1596377856195,1.0,0,568.51,5,1,0,7.89,5,1,0,7.944117934422792
Windmill,2023-06-17,Czech Republic Mixed @ Windmill,New Age Mix,13,9,418.5661446562001,1.0,0,211.08,4,1,0,0.10999999999999943,4,1,0,1.77736113440886
Windmill,2023-06-17,Czech Republic Mixed @ Windmill,Switzerland Mixed @ Windmill,15,12,300.4922431832018,1.0,0,134.77,3,1,0,3.42,3,1,0,0.8750054732152766
Windmill,2023-06-17,DISConnection,EuroTrash @ Windmill,15,8,564.8086448756737,1.0,0,193.32999999999998,7,1,0,-0.8599999999999994,7,1,0,2.6327055232850185
Windmill,2023-06-17,DISConnection,Too Many Cooks,15,7,600.0,1.0,0,301.44,8,1,0,3.54,8,1,0,4.987681674074256
Windmill,2023-06-17,Deep Space,EuroTrash @ Windmill,12,10,238.1225775586291,1.0,0,308.24,2,1,0,2.62,2,1,0,4.090799488476804
Windmill,2023-06-17,Deep Space,Frizstyle FBF,14,10,398.70186369942724,1.0,0,250.63000000000002,4,1,0,6.1899999999999995,4,1,0,3.0498964190229714
Windmill,2023-06-17,Deep Space,New Age Mix,14,10,398.70186369942724,1.0,0,352.38,4,1,0,3.4099999999999993,4,1,0,4.218212299184639
Windmill,2023-06-17,Denmark Mixed @ Windmill,DISConnection,11,10,125.0,1.0,0,-112.09,1,1,0,-1.5700000000000003,1,1,0,-1.9354013027493764
Windmill,2023-06-17,Denmark Mixed @ Windmill,New Age Mix,12,12,0.0,1.0,0,125.38,0,1,0,-1.6400000000000006,0,1,0,0.8510849287176896
Windmill,2023-06-17,Denmark Mixed @ Windmill,Switzerland Mixed @ Windmill,12,9,345.3654772346762,1.0,0,49.06999999999999,3,1,0,1.67,3,1,0,-0.057749714668567265
Windmill,2023-06-17,Disckatus Ultimate Madrid @ Windmill,Fusion Falcons Ultimate Club,13,7,557.5316737222639,1.0,0,135.7,6,1,0,5.779999999999999,6,1,0,2.623981851192365
Windmill,2023-06-17,Ellipsis @ Windmill,Austria Mixed @ Windmill,13,11,228.8403622143806,1.0,0,192.12,2,1,0,5.4,2,1,0,1.1489948102261351
Windmill,2023-06-17,Ellipsis @ Windmill,EuroTrash @ Windmill,15,8,564.8086448756737,1.0,0,423.25,7,1,0,7.65,7,1,0,6.181647116418997
Windmill,2023-06-17,Ellipsis @ Windmill,GRUT,14,13,125.0,1.0,0,-61.83000000000004,1,1,0,3.09,1,1,0,-0.035249935110767794
Windmill,2023-06-17,Estonia Mixed @ Windmill,Chang Chi and the Legend of 20ish Rings @ Windmill,14,11,313.3379659704299,1.0,0,-91.17000000000002,3,1,0,-3.9400000000000004,3,1,0,-1.3024617715142348
Windmill,2023-06-17,Estonia Mixed @ Windmill,Farmer Brown's Greenhouse (FBG) @ Windmill,13,8,496.1596377856195,1.0,0,-35.22999999999996,5,1,0,-2.17,5,1,0,0.5929408723694696
Windmill,2023-06-17,EuroTrash @ Windmill,Switzerland Mixed @ Windmill,13,12,125.0,1.0,0,-32.16999999999999,1,1,0,4.1,1,1,0,-0.7710697531460564
Windmill,2023-06-17,Farmer Brown's Greenhouse (FBG) @ Windmill,FRuBB,14,8,536.0348119187572,1.0,0,329.76,6,1,0,4.44,6,1,0,4.859196742093523
Windmill,2023-06-17,Farmer Brown's Greenhouse (FBG) @ Windmill,Smog,15,8,564.8086448756737,1.0,0,354.39,7,1,0,5.69,7,1,0,4.441645512048421
Windmill,2023-06-17,Farmer Brown's Greenhouse (FBG) @ Windmill,Swedish Royals @ Windmill,9,9,0.0,0.9733285267845752,0,-0.7000000000000455,0,1,0,2.7,0,1,0,-1.3999141883757744
Windmill,2023-06-17,Finland Mixed @ Windmill,Denmark Mixed @ Windmill,11,9,249.2068104043629,1.0,0,170.57000000000002,2,1,0,2.6100000000000003,2,1,0,1.1303530507511397
Windmill,2023-06-17,Finland Mixed @ Windmill,HORANGI,12,8,441.15462425988915,1.0,0,401.74,4,1,0,4.92,4,1,0,3.358383290394169
Windmill,2023-06-17,Finland Mixed @ Windmill,Pampered cats @ Windmill,15,9,515.4814780292847,1.0,0,334.16,6,1,0,6.3100000000000005,6,1,0,4.0066613291032525
Windmill,2023-06-17,Force Elektro MXD,Kingdom of Raptors @ Windmill,10,9,125.0,1.0,0,199.76,1,1,0,1.75,1,1,0,2.1157980958889624
Windmill,2023-06-17,Force Elektro MXD,Steamhuck,11,9,249.2068104043629,1.0,0,130.32,2,1,0,1.1800000000000002,2,1,0,1.3225567271445513
Windmill,2023-06-17,France Mixed @ Windmill,Ireland Mixed @ Windmill,12,11,125.0,1.0,0,16.709999999999923,1,1,0,2.0500000000000007,1,1,0,1.146757986432661
Windmill,2023-06-17,Frizstyle FBF,FRuBB,15,8,564.8086448756737,1.0,0,55.58000000000001,7,1,0,-0.8899999999999999,7,1,0,1.690043649286821
Windmill,2023-06-17,Frizstyle FBF,Too Many Cooks,12,10,238.1225775586291,1.0,0,165.72,2,1,0,0.83,2,1,0,3.559343611144957
Windmill,2023-06-17,GRUT,Ireland Mixed @ Windmill,13,7,557.5316737222639,1.0,0,-92.90999999999997,6,1,0,-0.11999999999999922,6,1,0,-2.3424252820971017
Windmill,2023-06-17,GRUT,Italy Mixed @ Windmill,15,10,453.6039151898044,1.0,0,-19.979999999999905,5,1,0,1.5299999999999994,5,1,0,-0.726181875185457
Windmill,2023-06-17,Germany Mixed @ Windmill,Austria Mixed @ Windmill,15,5,600.0,1.0,0,511.54999999999995,10,1,0,10.29,10,1,0,6.739824651424339
Windmill,2023-06-17,Germany Mixed @ Windmill,France Mixed @ Windmill,14,10,398.70186369942724,1.0,0,147.98000000000002,4,1,0,5.809999999999999,4,1,0,2.535916786171555
Windmill,2023-06-17,Germany Mixed @ Windmill,Great Britain Mixed @ Windmill,15,12,300.4922431832018,1.0,0,-2.7000000000000455,3,1,0,4.919999999999998,3,1,0,1.3032061135931379
Windmill,2023-06-17,Great Britain Mixed @ Windmill,Ellipsis @ Windmill,14,8,536.0348119187572,1.0,0,322.13,6,1,0,-0.02999999999999936,6,1,0,4.642603818189578
Windmill,2023-06-17,Great Britain Mixed @ Windmill,GRUT,14,10,398.70186369942724,1.0,0,260.29999999999995,4,1,0,3.0600000000000005,4,1,0,4.610707434682876
Windmill,2023-06-17,Great Britain Mixed @ Windmill,Germany Mixed @ Windmill,14,11,313.3379659704299,1.0,0,2.7000000000000455,3,1,0,-4.919999999999998,3,1,0,-1.303206113593136
Windmill,2023-06-17,HORANGI,Disckatus Ultimate Madrid @ Windmill,15,8,564.8086448756737,1.0,0,115.94,7,1,0,-1.95,7,1,0,2.936836262312436
Windmill,2023-06-17,Ireland Mixed @ Windmill,Austria Mixed @ Windmill,15,7,600.0,1.0,0,346.86,8,1,0,2.4299999999999997,8,1,0,3.483516656278475
Windmill,2023-06-17,Ireland Mixed @ Windmill,France Mixed @ Windmill,11,7,466.8933257329327,0.9733285267845752,0,-16.709999999999923,4,1,0,-2.0500000000000007,4,1,0,-1.1467579864326627
Windmill,2023-06-17,Italy Mixed @ Windmill,Chang Chi and the Legend of 20ish Rings @ Windmill,12,10,238.1225775586291,1.0,0,117.32999999999993,2,1,0,-0.5,2,1,0,0.9863247707353207
Windmill,2023-06-17,Italy Mixed @ Windmill,DISConnection,15,6,600.0,1.0,0,311.72999999999996,9,1,0,3.8900000000000006,9,1,0,4.528379649413711
Windmill,2023-06-17,Italy Mixed @ Windmill,France Mixed @ Windmill,12,10,238.1225775586291,1.0,0,-89.63999999999999,2,1,0,-3.6999999999999993,2,1,0,-2.7524672665264145
Windmill,2023-06-17,Kingdom of Raptors @ Windmill,LoL Mixed Ultimate Team,15,9,515.4814780292847,1.0,0,190.41,6,1,0,3.9800000000000004,6,1,0,2.870421918235415
Windmill,2023-06-17,Kingdom of Raptors @ Windmill,Norway Mixed @ Windmill,13,11,228.8403622143806,1.0,0,92.81999999999996,2,1,0,1.8900000000000006,2,1,0,1.4630834871668803
Windmill,2023-06-17,Lithuania Mixed @ Windmill,Smog,13,11,228.8403622143806,1.0,0,217.91000000000003,2,1,0,1.6899999999999997,2,1,0,3.7125293521364497
Windmill,2023-06-17,LoL Mixed Ultimate Team,DTU,12,4,600.0,0.9459053029269173,0,34.44999999999999,8,1,0,-1.6900000000000004,8,1,0,0.3112053368327228
Windmill,2023-06-17,NOISE Ultimate @ Windmill,Belgium Mixed @ Windmill,13,11,228.8403622143806,1.0,0,190.33999999999997,2,1,0,3.7700000000000005,2,1,0,2.5883412433763127
Windmill,2023-06-17,NOISE Ultimate @ Windmill,FRuBB,15,6,600.0,1.0,0,228.95,9,1,0,5.82,9,1,0,3.443045608131385
Windmill,2023-06-17,NOISE Ultimate @ Windmill,HORANGI,14,11,313.3379659704299,1.0,0,380.90999999999997,3,1,0,7.88,3,1,0,4.353210968995324
Windmill,2023-06-17,NOISE Ultimate @ Windmill,Smog,15,11,381.1647521399218,1.0,0,253.57999999999998,4,1,0,7.07,4,1,0,3.0024111408515317
Windmill,2023-06-17,Norway Mixed @ Windmill,DTU,14,12,220.95664314305532,1.0,0,132.04000000000002,2,1,0,0.39999999999999947,2,1,0,1.7418565478784274
Windmill,2023-06-17,Norway Mixed @ Windmill,LoL Mixed Ultimate Team,15,10,453.6039151898044,1.0,0,97.59000000000003,5,1,0,2.09,5,1,0,1.4341062921360006
Windmill,2023-06-17,Norway Mixed @ Windmill,Rainbow Brigade @ Windmill,12,11,125.0,1.0,0,-3.25,1,1,0,-2.0500000000000003,1,1,0,-0.42438671035787756
Windmill,2023-06-17,PUC,Disckatus Ultimate Madrid @ Windmill,13,11,228.8403622143806,1.0,0,104.97,2,1,0,-0.8999999999999999,2,1,0,2.1047707614550575
Windmill,2023-06-17,PUC,FRuBB,15,10,453.6039151898044,1.0,0,-162.92999999999998,5,1,0,-1.0099999999999998,5,1,0,-1.8239302060231442
Windmill,2023-06-17,PUC,Pampered cats @ Windmill,11,10,125.0,1.0,0,-78.55,1,1,0,2.4400000000000004,1,1,0,-0.16649316218199317
Windmill,2023-06-17,Pampered cats @ Windmill,Force Elektro MXD,12,8,441.15462425988915,1.0,0,95.96000000000001,4,1,0,0.9399999999999997,4,1,0,1.8985137772713259
Windmill,2023-06-17,Poland Mixed @ Windmill,Deep Space,13,6,600.0,1.0,0,78.80999999999995,7,1,0,-4.55,7,1,0,1.91253381150689
Windmill,2023-06-17,Poland Mixed @ Windmill,Lithuania Mixed @ Windmill,13,10,328.14240231865136,1.0,0,191.73999999999995,3,1,0,0.31000000000000005,3,1,0,2.438179998276766
Windmill,2023-06-17,Rainbow Brigade @ Windmill,DTU,12,10,238.1225775586291,1.0,0,135.29000000000002,2,1,0,2.4499999999999997,2,1,0,2.1591495329878505
Windmill,2023-06-17,Rainbow Brigade @ Windmill,Fusion Falcons Ultimate Club,11,9,249.2068104043629,1.0,0,-66.07,2,1,0,-0.0900000000000003,2,1,0,-0.1454954368067387
Windmill,2023-06-17,Rainbow Brigade @ Windmill,LoL Mixed Ultimate Team,11,9,249.2068104043629,1.0,0,100.84000000000003,2,1,0,4.140000000000001,2,1,0,1.8534794176780558
Windmill,2023-06-17,Smog,Frizstyle FBF,10,10,0.0,1.0,0,-80.21,0,1,0,-0.3599999999999999,0,1,0,-1.232465261772738
Windmill,2023-06-17,Steamhuck,DTU,15,7,600.0,1.0,0,294.29999999999995,8,1,0,2.86,8,1,0,3.927839968725042
Windmill,2023-06-17,Steamhuck,Fusion Falcons Ultimate Club,10,8,262.66557693448596,0.9733285267845752,0,92.93999999999997,2,1,0,0.31999999999999984,2,1,0,1.6944863740348381
Windmill,2023-06-17,Steamhuck,Kingdom of Raptors @ Windmill,12,10,238.1225775586291,1.0,0,69.44,2,1,0,0.5699999999999998,2,1,0,0.8032309305102636
Windmill,2023-06-17,Swedish Royals @ Windmill,Estonia Mixed @ Windmill,13,11,228.8403622143806,1.0,0,35.93000000000001,2,1,0,-0.5300000000000002,2,1,0,0.8099614124741841
Windmill,2023-06-17,Swedish Royals @ Windmill,Lithuania Mixed @ Windmill,14,13,125.0,1.0,0,137.18,1,1,0,1.3000000000000003,1,1,0,2.176039315314796
Windmill,2023-06-17,Swedish Royals @ Windmill,Poland Mixed @ Windmill,15,8,564.8086448756737,1.0,0,-54.559999999999945,7,1,0,0.9900000000000002,7,1,0,-0.268471326979844
Windmill,2023-06-17,Switzerland Mixed @ Windmill,Finland Mixed @ Windmill,9,8,125.0,0.9459053029269173,0,-219.64000000000001,1,1,0,-4.28,1,1,0,-1.0729146127697486
Windmill,2023-06-17,Too Many Cooks,Disckatus Ultimate Madrid @ Windmill,13,12,125.0,1.0,0,157.76,1,1,0,-1.6099999999999999,1,1,0,2.008367997442118
Windmill,2023-06-17,Too Many Cooks,Pampered cats @ Windmill,13,10,328.14240231865136,1.0,0,-25.759999999999998,3,1,0,1.73,3,1,0,-0.26472251156467586
Windmill,2023-06-18,Chang Chi and the Legend of 20ish Rings @ Windmill,Swedish Royals @ Windmill,14,12,220.95664314305532,1.0,0,55.24000000000001,2,1,0,4.470000000000001,2,1,0,0.4948203932363029
Windmill,2023-06-18,Czech Republic Mixed @ Windmill,EuroTrash @ Windmill,15,8,564.8086448756737,1.0,0,166.94,7,1,0,-0.6799999999999997,7,1,0,1.6411540235817448
Windmill,2023-06-18,DISConnection,Frizstyle FBF,15,12,300.4922431832018,1.0,0,135.72,3,1,0,2.71,3,1,0,1.5506900802810009
Windmill,2023-06-18,Deep Space,NOISE Ultimate @ Windmill,14,12,220.95664314305532,1.0,0,77.26000000000005,2,1,0,-0.5200000000000005,2,1,0,1.2816175825370877
Windmill,2023-06-18,Denmark Mixed @ Windmill,PUC,11,7,466.8933257329327,0.9733285267845752,0,242.14,4,1,0,1.2599999999999998,4,1,0,3.0951638841591453
Windmill,2023-06-18,FRuBB,Kingdom of Raptors @ Windmill,15,13,214.17926913507503,1.0,0,380.1,2,1,0,6.14,2,1,0,5.445170762050445
Windmill,2023-06-18,Farmer Brown's Greenhouse (FBG) @ Windmill,Lithuania Mixed @ Windmill,14,12,220.95664314305532,1.0,0,136.47999999999996,2,1,0,4.0,2,1,0,0.7867772811620615
Windmill,2023-06-18,Finland Mixed @ Windmill,Belgium Mixed @ Windmill,12,8,441.15462425988915,1.0,0,211.17000000000002,4,1,0,0.8100000000000005,4,1,0,1.543269852007711
Windmill,2023-06-18,Force Elektro MXD,LoL Mixed Ultimate Team,14,6,600.0,1.0,0,390.17,8,1,0,5.73,8,1,0,4.855168586601934
Windmill,2023-06-18,France Mixed @ Windmill,Austria Mixed @ Windmill,14,8,536.0348119187572,1.0,0,363.56999999999994,6,1,0,4.48,6,1,0,4.54950077293865
Windmill,2023-06-18,Fusion Falcons Ultimate Club,DTU,13,8,496.1596377856195,1.0,0,201.36,5,1,0,2.54,5,1,0,2.301431696494582
Windmill,2023-06-18,GRUT,Germany Mixed @ Windmill,12,11,125.0,1.0,0,-257.5999999999999,1,1,0,-7.979999999999999,1,1,0,-5.760088412985121
Windmill,2023-06-18,Great Britain Mixed @ Windmill,Italy Mixed @ Windmill,14,12,220.95664314305532,1.0,0,240.32000000000005,2,1,0,4.59,2,1,0,3.943204155703061
Windmill,2023-06-18,Ireland Mixed @ Windmill,Ellipsis @ Windmill,12,10,238.1225775586291,1.0,0,154.74,2,1,0,-2.9700000000000006,2,1,0,2.37680297974903
Windmill,2023-06-18,New Age Mix,HORANGI,13,9,418.5661446562001,1.0,0,105.78999999999999,4,1,0,3.95,4,1,0,1.4274177046488319
Windmill,2023-06-18,Pampered cats @ Windmill,Disckatus Ultimate Madrid @ Windmill,12,11,125.0,1.0,0,183.52,1,1,0,-3.34,1,1,0,2.267732007234173
Windmill,2023-06-18,Poland Mixed @ Windmill,Estonia Mixed @ Windmill,14,10,398.70186369942724,1.0,0,90.48999999999995,4,1,0,-1.5200000000000005,4,1,0,1.077391493653895
Windmill,2023-06-18,Steamhuck,Norway Mixed @ Windmill,11,8,365.60925011032475,1.0,0,162.25999999999996,3,1,0,2.4600000000000004,3,1,0,2.2545387721804566
Windmill,2023-06-18,Switzerland Mixed @ Windmill,Smog,10,9,125.0,1.0,0,54.769999999999996,1,1,0,-0.17000000000000004,1,1,0,0.9019107429372202
Windmill,2023-06-18,Too Many Cooks,Rainbow Brigade @ Windmill,14,9,473.8676990361691,1.0,0,359.53,5,1,0,4.26,5,1,0,4.658195805897478
EUCR Brno,2023-08-27,AKS ZŁY ULTIMATE,Catchup Mixed,15,9,515.4814780292847,1.0,0,282.95,6,1,0,0.7,6,1,0,3.309189596790713
EUCR Brno,2023-08-27,AKS ZŁY ULTIMATE,Left Overs,12,11,125.0,1.0,0,-175.69,1,1,0,-0.75,1,1,0,-1.6278143168244092
EUCR Brno,2023-08-27,AKS ZŁY ULTIMATE,Mosquitos,15,13,214.17926913507503,1.0,0,49.37,2,1,0,0.19999999999999996,2,1,0,0.41839144560480435
EUCR Brno,2023-08-27,Catchup Mixed,OUT,15,5,600.0,1.0,0,87.19,10,1,0,5.86,10,1,0,2.3585201340782156
EUCR Brno,2023-08-27,Catchup Mixed,Rubber Duckies,15,7,600.0,1.0,0,539.29,8,1,0,8.66,8,1,0,7.192098105315903
EUCR Brno,2023-08-27,Catchup Mixed,ZomBees,14,12,220.95664314305532,1.0,0,253.26,2,1,0,5.81,2,1,0,3.717457324648457
EUCR Brno,2023-08-27,KS FLOW WROCŁAW,AKS ZŁY ULTIMATE,13,9,418.5661446562001,1.0,0,-36.59,4,1,0,-1.3699999999999999,4,1,0,-0.39365958546729907
EUCR Brno,2023-08-27,KS FLOW WROCŁAW,Mosquitos,13,10,328.14240231865136,1.0,0,12.779999999999994,3,1,0,-1.17,3,1,0,0.02474997753939867
EUCR Brno,2023-08-27,KS FLOW WROCŁAW,Savage Ultimate,14,13,125.0,1.0,0,25.959999999999994,1,1,0,1.03,1,1,0,0.5936896989592189
EUCR Brno,2023-08-27,Left Overs,AKS ZŁY ULTIMATE,13,9,418.5661446562001,1.0,0,175.69,4,1,0,0.75,4,1,0,1.6278143168244092
EUCR Brno,2023-08-27,Left Overs,KS FLOW WROCŁAW,12,11,125.0,1.0,0,212.28,1,1,0,2.12,1,1,0,2.015733052369903
EUCR Brno,2023-08-27,Left Overs,Mosquitos,15,8,564.8086448756737,1.0,0,225.06,7,1,0,0.95,7,1,0,2.0400306930172647
EUCR Brno,2023-08-27,Left Overs,OUT,15,6,600.0,1.0,0,545.8299999999999,9,1,0,7.3100000000000005,9,1,0,6.834658521526851
EUCR Brno,2023-08-27,Mosquitos,Rubber Duckies,15,6,600.0,1.0,1,772.87,9,1,0,9.16,9,1,0,9.241551108473171
EUCR Brno,2023-08-27,Mosquitos,ZomBees,15,6,600.0,1.0,0,486.84,9,1,0,6.31,9,1,0,6.322318769263791
EUCR Brno,2023-08-27,OUT,Catchup Mixed,14,12,220.95664314305532,1.0,0,-87.19,2,1,0,-5.86,2,1,0,-2.3585201340782156
EUCR Brno,2023-08-27,OUT,Rubber Duckies,13,9,418.5661446562001,1.0,0,452.1,4,1,0,2.8,4,1,0,5.22769275668842
EUCR Brno,2023-08-27,OUT,ZomBees,14,8,536.0348119187572,1.0,0,166.07,6,1,0,-0.05000000000000071,6,1,0,1.414038813703396
EUCR Brno,2023-08-27,Savage Ultimate,Catchup Mixed,14,12,220.95664314305532,1.0,0,220.39999999999998,2,1,0,-1.7,2,1,0,2.3570571951954378
EUCR Brno,2023-08-27,Savage Ultimate,OUT,10,7,389.6652919127421,0.9459053029269173,0,307.59,3,1,0,4.16,3,1,0,4.601876878603811
EUCR Brno,2023-08-27,Savage Ultimate,Rubber Duckies,13,9,418.5661446562001,1.0,0,759.69,4,1,0,6.96,4,1,0,8.880101365963018
EUCR Brno,2023-08-27,Savage Ultimate,ZomBees,15,6,600.0,1.0,0,473.65999999999997,9,1,0,4.109999999999999,9,1,0,5.846819626419865
EUCR Brno,2023-08-27,ZomBees,Rubber Duckies,14,6,600.0,1.0,0,286.03000000000003,8,1,0,2.8500000000000005,8,1,0,3.943204155703061
EUCR Malmo,2023-08-27,Bremen Ultimate,DTU,15,12,300.4922431832018,1.0,0,549.24,3,1,0,10.29,3,1,0,7.631341112654805
EUCR Malmo,2023-08-27,Bremen Ultimate,Tartu Turbulence,14,11,313.3379659704299,1.0,0,-161.58999999999997,3,1,0,2.2800000000000002,3,1,0,-1.971527999815562
EUCR Malmo,2023-08-27,DTU,Gentle Mixed,12,9,345.3654772346762,1.0,0,-281.98,3,1,0,-4.17,3,1,0,-4.672422246629377
EUCR Malmo,2023-08-27,DTU,Owls UC,12,9,345.3654772346762,1.0,0,83.28000000000003,3,1,0,2.5199999999999996,3,1,0,-0.12674698333053414
EUCR Malmo,2023-08-27,GRUT,Bremen Ultimate,14,9,473.8676990361691,1.0,0,538.7700000000001,5,1,0,5.38,5,1,0,7.094092498445491
EUCR Malmo,2023-08-27,GRUT,Nullacht! Ultimate,15,11,381.1647521399218,1.0,0,421.7900000000001,4,1,0,1.2400000000000002,4,1,0,5.865889932079007
EUCR Malmo,2023-08-27,GRUT,Nullacht! Ultimate,15,10,453.6039151898044,1.0,0,421.7900000000001,5,1,0,1.2400000000000002,5,1,0,5.865889932079007
EUCR Malmo,2023-08-27,GRUT,Owls UC,15,6,600.0,1.0,1,1171.29,9,1,0,18.189999999999998,9,1,0,11.821800025860384
EUCR Malmo,2023-08-27,GRUT,Tartu Turbulence,15,12,300.4922431832018,1.0,0,377.18000000000006,3,1,0,7.66,3,1,0,5.462093109943364
EUCR Malmo,2023-08-27,GRUT,Tartu Turbulence,15,11,381.1647521399218,1.0,0,377.18000000000006,4,1,0,7.66,4,1,0,5.462093109943364
EUCR Malmo,2023-08-27,Gentle Mixed,DTU,14,7,582.8868714046324,1.0,0,281.98,7,1,0,4.17,7,1,0,4.672422246629377
EUCR Malmo,2023-08-27,Gentle Mixed,Malmö Ultimate Club,10,9,125.0,1.0,0,-126.56,1,1,0,-0.8699999999999999,1,1,0,-1.230975376006965
EUCR Malmo,2023-08-27,Gentle Mixed,Owls UC,15,6,600.0,1.0,0,365.26,9,1,0,6.6899999999999995,9,1,0,4.557671366781939
EUCR Malmo,2023-08-27,Gentle Mixed,Owls UC,12,10,238.1225775586291,1.0,0,365.26,2,1,0,6.6899999999999995,2,1,0,4.557671366781939
EUCR Malmo,2023-08-27,Malmö Ultimate Club,DTU,14,8,536.0348119187572,1.0,0,408.53999999999996,6,1,0,5.04,6,1,0,5.756251543456578
EUCR Malmo,2023-08-27,Malmö Ultimate Club,DTU,13,9,418.5661446562001,1.0,0,408.53999999999996,4,1,0,5.04,4,1,0,5.756251543456578
EUCR Malmo,2023-08-27,Malmö Ultimate Club,Owls UC,13,8,496.1596377856195,1.0,0,491.82000000000005,5,1,0,7.56,5,1,0,5.647818238763087
EUCR Malmo,2023-08-27,Malmö Ultimate Club,Owls UC,13,5,600.0,1.0,0,491.82000000000005,8,1,0,7.56,8,1,0,5.647818238763087
EUCR Malmo,2023-08-27,Nullacht! Ultimate,Bremen Ultimate,13,12,125.0,1.0,0,116.98,1,1,0,4.14,1,1,0,1.5068997650978204
EUCR Malmo,2023-08-27,Nullacht! Ultimate,Bremen Ultimate,13,11,228.8403622143806,1.0,0,116.98,2,1,0,4.14,2,1,0,1.5068997650978204
EUCR Malmo,2023-08-27,Nullacht! Ultimate,Gentle Mixed,15,9,515.4814780292847,1.0,0,384.24,6,1,0,10.26,6,1,0,4.907473402633734
EUCR Malmo,2023-08-27,Tartu Turbulence,Bremen Ultimate,15,11,381.1647521399218,1.0,0,161.58999999999997,4,1,0,-2.2800000000000002,4,1,0,1.9715279998155637
EUCR Malmo,2023-08-27,Tartu Turbulence,Malmö Ultimate Club,8,6,300.4922431832018,0.8583950752789521,0,302.28999999999996,2,1,0,2.9699999999999998,2,1,0,4.215449388027547
EUCR Malmo,2023-08-27,Tartu Turbulence,Nullacht! Ultimate,13,11,228.8403622143806,1.0,0,44.609999999999985,2,1,0,-6.42,2,1,0,0.470845265304602
EUCR Strasbourg,2023-08-27,AUT BeeFire,CUS Bergamo Ultimate,14,9,473.8676990361691,1.0,0,281.5799999999999,5,1,0,4.06,5,1,0,3.431675766086286
EUCR Strasbourg,2023-08-27,AUT BeeFire,DiscoBolo,12,9,345.3654772346762,1.0,0,38.329999999999984,3,1,0,-1.8800000000000001,3,1,0,0.3426903599601072
EUCR Strasbourg,2023-08-27,DiscoBolo,CUS Bergamo Ultimate,15,9,515.4814780292847,1.0,0,243.24999999999994,6,1,0,5.9399999999999995,6,1,0,3.10521536216347
EUCR Strasbourg,2023-08-27,FlyHigh,AUT BeeFire,14,13,125.0,1.0,0,-74.75999999999999,1,1,0,-0.9199999999999999,1,1,0,-1.3850434561317364
EUCR Strasbourg,2023-08-27,FlyHigh,CUS Bergamo Ultimate,15,11,381.1647521399218,1.0,0,206.81999999999994,4,1,0,3.1399999999999997,4,1,0,2.090799473719443
EUCR Strasbourg,2023-08-27,FlyHigh,DiscoBolo,12,11,125.0,1.0,0,-36.43000000000001,1,1,0,-2.8,1,1,0,-1.0445566047662567
EUCR Strasbourg,2023-08-27,FucZH,AUT BeeFire,15,10,453.6039151898044,1.0,0,159.68,5,1,0,2.06,5,1,0,1.8579105455659999
EUCR Strasbourg,2023-08-27,FucZH,CUS Bergamo Ultimate,13,12,125.0,1.0,0,441.25999999999993,1,1,0,6.119999999999999,1,1,0,5.143827465227684
EUCR Strasbourg,2023-08-27,FucZH,FlyHigh,13,11,228.8403622143806,1.0,0,234.44,2,1,0,2.98,2,1,0,3.2062842722164007
EUCR Strasbourg,2023-08-27,Manchots,AUT BeeFire,14,9,473.8676990361691,1.0,0,494.59000000000003,5,1,0,6.0,5,1,0,6.128006717204055
EUCR Strasbourg,2023-08-27,Manchots,CUS Bergamo Ultimate,15,10,453.6039151898044,1.0,0,776.17,5,1,0,10.059999999999999,5,1,0,8.742569595178526
EUCR Strasbourg,2023-08-27,Manchots,FucZH,15,11,381.1647521399218,1.0,0,334.91,4,1,0,3.94,4,1,0,4.4976847848486585
EUCR Strasbourg,2023-08-27,Manchots,FucZH,14,9,473.8676990361691,1.0,0,334.91,5,1,0,3.94,5,1,0,4.4976847848486585
EUCR Strasbourg,2023-08-27,Manchots,Sesquidistus,12,11,125.0,1.0,0,-79.05000000000001,1,1,0,-2.25,1,1,0,-1.7263170433543902
EUCR Strasbourg,2023-08-27,Monkey Grenoble,DiscoBolo,15,8,564.8086448756737,1.0,0,664.52,7,1,0,9.09,7,1,0,7.8753537515019225
EUCR Strasbourg,2023-08-27,Monkey Grenoble,FlyHigh,15,8,564.8086448756737,1.0,0,700.95,7,1,0,11.89,7,1,0,8.605291240896058
EUCR Strasbourg,2023-08-27,Monkey Grenoble,FucZH,15,10,453.6039151898044,1.0,0,466.51,5,1,0,8.91,5,1,0,6.1536030741481405
EUCR Strasbourg,2023-08-27,Monkey Grenoble,Sesquidistus,13,11,228.8403622143806,1.0,0,52.549999999999955,2,1,0,2.7199999999999998,2,1,0,0.1642434356529563
EUCR Strasbourg,2023-08-27,Monkey Grenoble,Sesquidistus,13,12,125.0,1.0,0,52.549999999999955,1,1,0,2.7199999999999998,1,1,0,0.1642434356529563
EUCR Strasbourg,2023-08-27,Sesquidistus,AUT BeeFire,13,6,600.0,1.0,0,573.6400000000001,7,1,0,8.25,7,1,0,7.501618259832799
EUCR Strasbourg,2023-08-27,Sesquidistus,DiscoBolo,15,9,515.4814780292847,1.0,0,611.97,6,1,0,6.37,6,1,0,7.755696094625147
EUCR Strasbourg,2023-08-27,Sesquidistus,FlyHigh,15,11,381.1647521399218,1.0,0,648.4000000000001,4,1,0,9.17,4,1,0,8.494406366363645
EUCR Strasbourg,2023-08-27,Sesquidistus,Manchots,14,13,125.0,1.0,0,79.05000000000001,1,1,0,2.25,1,1,0,1.726317043354392
UK Nationals,2023-08-27,BN1,Flyght Mixed,15,10,453.6039151898044,1.0,0,432.89,5,1,0,1.42,5,1,0,4.9489539853465345
UK Nationals,2023-08-27,BN1,Thundering Herd,10,9,125.0,1.0,0,54.660000000000025,1,1,0,6.690000000000001,1,1,0,2.1084467980922597
UK Nationals,2023-08-27,Deep Space,BN1,15,5,600.0,1.0,1,872.62,10,1,0,10.0,10,1,0,10.779043016564362
UK Nationals,2023-08-27,Deep Space,Flyght Mixed,15,2,600.0,1.0,1,1305.51,13,1,0,11.42,13,1,0,12.713716716049806
UK Nationals,2023-08-27,Deep Space,Glasgow Mixed,15,5,600.0,1.0,0,510.36,10,1,0,7.59,10,1,0,6.124882272597624
UK Nationals,2023-08-27,Deep Space,Leamington Lemmings,12,7,520.5112660164395,1.0,0,189.90000000000003,5,1,0,0.7299999999999995,5,1,0,0.8241691303378111
UK Nationals,2023-08-27,Deep Space,Reading,12,8,441.15462425988915,1.0,0,41.97000000000003,4,1,0,3.09,4,1,0,-0.007499999374999788
UK Nationals,2023-08-27,Flyght Mixed,Zoo,13,5,600.0,1.0,0,147.93000000000006,8,1,0,4.67,8,1,0,3.383307646499496
UK Nationals,2023-08-27,Glasgow Mixed,BN1,14,8,536.0348119187572,1.0,0,362.26,6,1,0,2.4099999999999997,6,1,0,6.586920374756083
UK Nationals,2023-08-27,Glasgow Mixed,SMOG 2,15,7,600.0,1.0,0,140.98000000000002,8,1,0,9.22,8,1,0,3.371916087835473
UK Nationals,2023-08-27,Glasgow Mixed,Zoo,15,6,600.0,1.0,0,943.08,9,1,0,8.5,9,1,0,11.68840719484686
UK Nationals,2023-08-27,Leamington Lemmings,BN1,15,5,600.0,1.0,0,682.72,10,1,0,9.27,10,1,0,10.36408262280564
UK Nationals,2023-08-27,Leamington Lemmings,Glasgow Mixed,12,7,520.5112660164395,1.0,0,320.46,5,1,0,6.86,5,1,0,5.422365451009277
UK Nationals,2023-08-27,Leamington Lemmings,Smog,15,9,515.4814780292847,1.0,0,140.94,6,1,0,5.82,6,1,0,3.4409140803884988
UK Nationals,2023-08-27,Leamington Lemmings,Zoo,15,2,600.0,1.0,1,1263.54,13,1,0,15.36,13,1,0,13.350231155628265
UK Nationals,2023-08-27,Nemesis,Flyght Mixed,10,7,389.6652919127421,0.9459053029269173,0,17.049999999999955,3,1,0,-2.6300000000000003,3,1,0,-1.0751530772784843
UK Nationals,2023-08-27,Nemesis,Zoo,12,11,125.0,1.0,0,164.98000000000002,1,1,0,2.039999999999999,1,1,0,2.346083689925063
UK Nationals,2023-08-27,Oxford Ultimate,Flyght Mixed,13,8,496.1596377856195,1.0,0,417.22999999999996,5,1,0,-3.3000000000000003,5,1,0,4.775789831799859
UK Nationals,2023-08-27,Oxford Ultimate,Nemesis,15,6,600.0,1.0,0,400.18,9,1,0,-0.6699999999999999,9,1,0,5.720398206674439
UK Nationals,2023-08-27,Oxford Ultimate,Zoo,13,8,496.1596377856195,1.0,0,565.1600000000001,5,1,0,1.3699999999999992,5,1,0,7.612425005560677
UK Nationals,2023-08-27,Reading,Nemesis,15,6,600.0,1.0,1,1246.49,9,1,0,10.96,9,1,0,13.001012746538724
UK Nationals,2023-08-27,Reading,SMOG 2,15,6,600.0,1.0,0,609.37,9,1,0,13.719999999999999,9,1,0,8.703356754012955
UK Nationals,2023-08-27,Reading,Thundering Herd,15,5,600.0,1.0,0,885.31,10,1,0,13.600000000000001,10,1,0,11.708094184054424
UK Nationals,2023-08-27,SMOG 2,Oxford Ultimate,13,7,557.5316737222639,1.0,0,236.94,6,1,0,-2.09,6,1,0,3.7491166940260108
UK Nationals,2023-08-27,SMOG 2,Thundering Herd,15,6,600.0,1.0,0,275.94,9,1,0,-0.11999999999999922,9,1,0,5.491993397726912
UK Nationals,2023-08-27,Smog,Oxford Ultimate,15,7,600.0,1.0,0,557.44,8,1,0,8.17,8,1,0,8.361482765489871
UK Nationals,2023-08-27,Smog,Reading,14,11,313.3379659704299,1.0,0,-288.87,3,1,0,-3.46,3,1,0,-4.218902978422623
UK Nationals,2023-08-27,Smog,SMOG 2,15,9,515.4814780292847,1.0,0,320.5,6,1,0,10.26,6,1,0,5.359011535566644
UK Nationals,2023-08-27,Smog,Thundering Herd,15,6,600.0,1.0,0,596.44,9,1,0,10.14,9,1,0,9.595803244950215
UK Nationals,2023-08-27,Thundering Herd,Nemesis,14,9,473.8676990361691,1.0,0,361.18,5,1,0,-2.6400000000000006,5,1,0,3.996908662800365
