Tournament,Date,Team_1,Team_2,Score_1,Score_2,Game_Rank_Diff_USAU,Game_Wght_USAU,Is_Ignored_USAU,Team_Rank_Diff_USAU,Game_Rank_Diff_Windmill,Game_Wght_Windmill,Is_Ignored_Windmill,Team_Rank_Diff_Windmill,Game_Rank_Diff_Sigmoid,Game_Wght_Sigmoid,Is_Ignored_Sigmoid,Team_Rank_Diff_Sigmoid
Spring Invite Padova,2023-04-21,3SB - Women,Catchup Women,13,10,328.14240231865136,1.0,0,169.32,3,1,0,1.29,3,1,0,1.6367077455051735
Spring Invite Padova,2023-04-21,3SB - Women,Cheetahs,15,8,564.8086448756737,1.0,0,543.72,7,1,0,5.67,7,1,0,5.761367173085546
Spring Invite Padova,2023-04-21,3SB - Women,Panthers Wroclaw - Women,14,13,125.0,1.0,0,0.75,1,1,0,-0.17999999999999994,1,1,0,-0.08399912193101677
Spring Invite Padova,2023-04-21,CUS Padova Tane Malefiche,Catchup Women,15,8,564.8086448756737,1.0,0,544.99,7,1,0,5.91,7,1,0,6.25865476103235
Spring Invite Padova,2023-04-21,CUS Padova Tane Malefiche,DiscoBolo,12,8,441.15462425988915,1.0,0,442.99,4,1,0,5.41,4,1,0,5.471848720754373
Spring Invite Padova,2023-04-21,CUS Padova Tane Malefiche,East Block,15,13,214.17926913507503,1.0,0,-80.63,2,1,0,-1.2199999999999998,2,1,0,-1.4511967282077727
Spring Invite Padova,2023-04-21,CUS Padova Tane Malefiche,box vienna,15,9,515.4814780292847,1.0,0,134.24,6,1,0,1.96,6,1,0,2.0650532214240656
Spring Invite Padova,2023-04-21,Catchup Women,Cheetahs,14,11,313.3379659704299,1.0,0,374.4,3,1,0,4.38,3,1,0,4.305084051306817
Spring Invite Padova,2023-04-21,DiscoBolo,Cheetahs,10,6,496.1596377856195,0.9176629354822471,0,476.4,4,1,0,4.88,4,1,0,5.141841952721155
Spring Invite Padova,2023-04-21,East Block,DiscoBolo,15,10,453.6039151898044,1.0,0,523.62,5,1,0,6.63,5,1,0,6.687045382598466
Spring Invite Padova,2023-04-21,East Block,Tequila Boom Boom,15,9,515.4814780292847,1.0,0,105.81,6,1,0,2.27,6,1,0,2.49947327146646
Spring Invite Padova,2023-04-21,East Block,box vienna,15,5,600.0,1.0,0,214.87,10,1,0,3.1799999999999997,10,1,0,3.4700322282891634
Spring Invite Padova,2023-04-21,Panthers Wroclaw - Women,Catchup Women,15,10,453.6039151898044,1.0,0,168.57,5,1,0,1.47,5,1,0,1.719656103953234
Spring Invite Padova,2023-04-21,Panthers Wroclaw - Women,Catchup Women,12,8,441.15462425988915,1.0,0,168.57,4,1,0,1.47,4,1,0,1.719656103953234
Spring Invite Padova,2023-04-21,Panthers Wroclaw - Women,Cheetahs,15,8,564.8086448756737,1.0,0,542.97,7,1,0,5.85,7,1,0,5.832820551709293
Spring Invite Padova,2023-04-21,Shout,3SB - Women,15,11,381.1647521399218,1.0,0,562.6800000000001,4,1,0,6.62,4,1,0,6.820982657577801
Spring Invite Padova,2023-04-21,Shout,CUS Padova Tane Malefiche,11,8,365.60925011032475,1.0,0,187.01,3,1,0,2.0,3,1,0,2.319004725581145
Spring Invite Padova,2023-04-21,Shout,DiscoBolo,15,6,600.0,1.0,1,630.0,9,1,0,7.41,9,1,0,7.374932087786668
Spring Invite Padova,2023-04-21,Shout,East Block,15,14,125.0,1.0,0,106.38,1,1,0,0.7800000000000002,1,1,0,0.8809849164530732
Spring Invite Padova,2023-04-21,Shout,East Block,15,11,381.1647521399218,1.0,0,106.38,4,1,0,0.7800000000000002,4,1,0,0.8809849164530732
Spring Invite Padova,2023-04-21,Shout,box vienna,15,8,564.8086448756737,1.0,0,321.25,7,1,0,3.96,7,1,0,4.292692878871431
Spring Invite Padova,2023-04-21,Tequila Boom Boom,3SB - Women,15,11,381.1647521399218,1.0,0,350.49,4,1,0,3.57,4,1,0,3.8655947994621656
Spring Invite Padova,2023-04-21,Tequila Boom Boom,3SB - Women,13,12,125.0,1.0,0,350.49,1,1,0,3.57,1,1,0,3.8655947994621656
Spring Invite Padova,2023-04-21,Tequila Boom Boom,Catchup Women,15,12,300.4922431832018,1.0,0,519.81,3,1,0,4.859999999999999,3,1,0,5.351813152001132
Spring Invite Padova,2023-04-21,Tequila Boom Boom,Cheetahs,15,6,600.0,1.0,1,894.21,9,1,0,9.24,9,1,0,8.759884788887796
Spring Invite Padova,2023-04-21,Tequila Boom Boom,Panthers Wroclaw - Women,14,10,398.70186369942724,1.0,0,351.24,4,1,0,3.3899999999999997,4,1,0,3.787060937812562
Spring Invite Padova,2023-04-21,box vienna,CUS Padova Tane Malefiche,15,11,381.1647521399218,1.0,0,-134.24,4,1,0,-1.96,4,1,0,-2.0650532214240673
Spring Invite Padova,2023-04-21,box vienna,DiscoBolo,14,10,398.70186369942724,1.0,0,308.75,4,1,0,3.45,4,1,0,3.586933849263943
Spring Invite Padova,2023-04-21,box vienna,Panthers Wroclaw - Women,15,11,381.1647521399218,1.0,0,242.18,4,1,0,2.4800000000000004,4,1,0,2.825598264719936
Spring Invite UK,2023-04-23,Brighton @ Spring Invite UK,GB U20 Women Red @ Spring Invite UK,13,7,557.5316737222639,1.0,0,-44.27999999999997,6,1,0,-0.6800000000000015,6,1,0,1.3329744551741243
Spring Invite UK,2023-04-23,Brighton @ Spring Invite UK,Oxford Ultimate @ Spring Invite UK,15,6,600.0,1.0,0,298.53,9,1,0,4.26,9,1,0,5.989930263696536
Spring Invite UK,2023-04-23,Bristol,Horizon,15,2,600.0,1.0,1,690.13,13,1,0,8.1,13,1,0,9.114870794070246
Spring Invite UK,2023-04-23,Bristol,Reading 1 @ Spring Invite UK,15,10,453.6039151898044,1.0,0,210.27,5,1,0,1.8699999999999999,5,1,0,2.733619374290786
Spring Invite UK,2023-04-23,Bristol,SMOG Women @ Spring Invite UK,14,8,536.0348119187572,1.0,0,314.84000000000003,6,1,0,3.54,6,1,0,4.262376498524045
Spring Invite UK,2023-04-23,Bristol,SY-See @ Spring Invite UK,14,8,536.0348119187572,1.0,0,361.59000000000003,6,1,0,5.27,6,1,0,5.750494582644684
Spring Invite UK,2023-04-23,Bristol,Spice,14,10,398.70186369942724,1.0,0,31.53,4,1,0,0.3700000000000001,4,1,0,0.759849050080911
Spring Invite UK,2023-04-23,Brixton @ Spring Invite UK,Brighton @ Spring Invite UK,12,5,600.0,0.9459053029269173,0,-54.40999999999997,7,1,0,0.47000000000000064,7,1,0,-0.8361323750127276
Spring Invite UK,2023-04-23,Brixton @ Spring Invite UK,Chameleons,12,3,600.0,0.9459053029269173,0,403.6500000000001,9,1,0,5.879999999999999,9,1,0,8.736129232190418
Spring Invite UK,2023-04-23,Brixton @ Spring Invite UK,Oxford Ultimate @ Spring Invite UK,9,7,279.3368557106305,0.9176629354822471,0,244.12,2,1,0,4.73,2,1,0,5.271130312064784
Spring Invite UK,2023-04-23,GB U20 Women Blue @ Spring Invite UK,Brixton @ Spring Invite UK,9,6,418.5661446562001,0.8885233166386386,0,84.92999999999995,3,1,0,0.22000000000000064,3,1,0,0.10799813379869683
Spring Invite UK,2023-04-23,GB U20 Women Blue @ Spring Invite UK,Chameleons,13,0,600.0,1.0,0,488.58000000000004,13,1,0,6.1,13,1,0,8.807196417238053
Spring Invite UK,2023-04-23,GB U20 Women Blue @ Spring Invite UK,GB U20 Women Red @ Spring Invite UK,5,4,125.0,0.6882472016116853,0,-13.759999999999991,1,1,0,0.009999999999999787,1,1,0,0.6071680671544382
Spring Invite UK,2023-04-23,GB U20 Women Blue @ Spring Invite UK,Oxford Ultimate @ Spring Invite UK,8,6,300.4922431832018,0.8583950752789521,0,329.04999999999995,2,1,0,4.950000000000001,2,1,0,5.365553066328946
Spring Invite UK,2023-04-23,GB U20 Women Red @ Spring Invite UK,Brixton @ Spring Invite UK,9,6,418.5661446562001,0.8885233166386386,0,98.68999999999994,3,1,0,0.21000000000000085,3,1,0,-0.4993154516720857
Spring Invite UK,2023-04-23,GB U20 Women Red @ Spring Invite UK,Chameleons,10,4,600.0,0.8583950752789521,0,502.34000000000003,6,1,0,6.09,6,1,0,8.399658303740452
Spring Invite UK,2023-04-23,GB U20 Women Red @ Spring Invite UK,Chameleons,15,7,600.0,1.0,0,502.34000000000003,8,1,0,6.09,8,1,0,8.399658303740452
Spring Invite UK,2023-04-23,GB U20 Women Red @ Spring Invite UK,GB U20 Women Blue @ Spring Invite UK,1,1,0.0,0.3244428422615251,0,13.759999999999991,0,1,0,-0.009999999999999787,0,1,0,-0.6071680671544382
Spring Invite UK,2023-04-23,GB U20 Women Red @ Spring Invite UK,Oxford Ultimate @ Spring Invite UK,11,3,600.0,0.9176629354822471,0,342.80999999999995,8,1,0,4.940000000000001,8,1,0,4.828294246774888
Spring Invite UK,2023-04-23,Gravity,Brighton @ Spring Invite UK,15,6,600.0,1.0,1,639.77,9,1,0,10.020000000000001,9,1,0,11.728552999776053
Spring Invite UK,2023-04-23,Gravity,Bristol,10,9,125.0,1.0,0,-197.56,1,1,0,-2.03,1,1,0,-2.4980148962810897
Spring Invite UK,2023-04-23,Gravity,LMU @ Spring Invite UK,14,10,398.70186369942724,1.0,0,-180.60999999999999,4,1,0,-2.4,4,1,0,-2.189987496188907
Spring Invite UK,2023-04-23,Gravity,Reading 1 @ Spring Invite UK,13,10,328.14240231865136,1.0,0,12.709999999999999,3,1,0,-0.16000000000000003,3,1,0,0.24297874459130497
Spring Invite UK,2023-04-23,Gravity,SCRAM,13,5,600.0,1.0,0,324.07,8,1,0,4.6,8,1,0,4.867921725991113
Spring Invite UK,2023-04-23,Gravity,Spice,15,6,600.0,1.0,0,-166.03,9,1,0,-1.6599999999999997,9,1,0,-1.752953876088318
Spring Invite UK,2023-04-23,Horizon,Chameleons,15,1,600.0,1.0,0,605.26,14,1,0,9.36,14,1,0,12.660568655226584
Spring Invite UK,2023-04-23,Horizon,GB U20 Women Blue @ Spring Invite UK,15,4,600.0,1.0,0,116.68,11,1,0,3.26,11,1,0,7.6391205970805665
Spring Invite UK,2023-04-23,Horizon,SY-Sea @ Spring Invite UK,15,12,300.4922431832018,1.0,0,-15.819999999999993,3,1,0,-0.16999999999999993,3,1,0,1.4861087909334643
Spring Invite UK,2023-04-23,Iceni,Reading 1 @ Spring Invite UK,15,11,381.1647521399218,1.0,0,289.66999999999996,4,1,0,2.8,4,1,0,3.7434909552442974
Spring Invite UK,2023-04-23,Iceni,SCRAM,15,6,600.0,1.0,1,601.03,9,1,0,7.5600000000000005,9,1,0,7.790258016839427
Spring Invite UK,2023-04-23,Iceni,SY-Sea @ Spring Invite UK,15,5,600.0,1.0,1,753.71,10,1,0,8.86,10,1,0,10.560475664509788
Spring Invite UK,2023-04-23,Iceni,SY-See @ Spring Invite UK,15,3,600.0,1.0,0,440.99,12,1,0,6.2,12,1,0,6.629231417437882
Spring Invite UK,2023-04-23,LMU @ Spring Invite UK,Iceni,15,8,564.8086448756737,1.0,0,-96.35,7,1,0,-0.56,7,1,0,-1.3716574480563075
Spring Invite UK,2023-04-23,LMU @ Spring Invite UK,SMOG Women @ Spring Invite UK,15,10,453.6039151898044,1.0,0,297.89,5,1,0,3.91,5,1,0,3.9704188188502556
Spring Invite UK,2023-04-23,LMU @ Spring Invite UK,SY-Sea @ Spring Invite UK,15,6,600.0,1.0,0,657.36,9,1,0,8.3,9,1,0,9.821093918128692
Spring Invite UK,2023-04-23,LMU @ Spring Invite UK,Spice,13,10,328.14240231865136,1.0,0,14.579999999999984,3,1,0,0.7400000000000002,3,1,0,0.44461971590345506
Spring Invite UK,2023-04-23,Oxford Ultimate @ Spring Invite UK,Chameleons,8,5,453.6039151898044,0.8271701918685112,0,159.5300000000001,3,1,0,1.1499999999999986,3,1,0,4.356644879019189
Spring Invite UK,2023-04-23,Oxford Ultimate @ Spring Invite UK,Chameleons,15,7,600.0,1.0,0,159.5300000000001,8,1,0,1.1499999999999986,8,1,0,4.356644879019189
Spring Invite UK,2023-04-23,Reading 1 @ Spring Invite UK,LMU @ Spring Invite UK,15,12,300.4922431832018,1.0,0,-193.32,3,1,0,-2.24,3,1,0,-2.4272259010128145
Spring Invite UK,2023-04-23,Reading 1 @ Spring Invite UK,SMOG Women @ Spring Invite UK,13,12,125.0,1.0,0,104.57,1,1,0,1.67,1,1,0,1.612248033375188
Spring Invite UK,2023-04-23,Reading 1 @ Spring Invite UK,SY-Sea @ Spring Invite UK,15,6,600.0,1.0,0,464.04,9,1,0,6.06,9,1,0,8.270053070564817
Spring Invite UK,2023-04-23,SCRAM,Brighton @ Spring Invite UK,15,6,600.0,1.0,0,315.7,9,1,0,5.420000000000001,9,1,0,9.193471799428142
Spring Invite UK,2023-04-23,SMOG Women @ Spring Invite UK,Horizon,14,8,536.0348119187572,1.0,0,375.28999999999996,6,1,0,4.56,6,1,0,5.865254615206194
Spring Invite UK,2023-04-23,SMOG Women @ Spring Invite UK,SY-See @ Spring Invite UK,13,10,328.14240231865136,1.0,0,46.75,3,1,0,1.73,3,1,0,1.6700476822475174
Spring Invite UK,2023-04-23,SY-Sea @ Spring Invite UK,Brixton @ Spring Invite UK,14,9,473.8676990361691,1.0,0,217.42999999999995,5,1,0,3.6500000000000004,5,1,0,6.567534773016682
Spring Invite UK,2023-04-23,SY-Sea @ Spring Invite UK,Oxford Ultimate @ Spring Invite UK,15,0,600.0,1.0,0,461.54999999999995,15,1,0,8.38,15,1,0,10.260059940863119
Spring Invite UK,2023-04-23,SY-See @ Spring Invite UK,Horizon,14,7,582.8868714046324,1.0,0,328.53999999999996,7,1,0,2.8299999999999996,7,1,0,4.386155887833482
Spring Invite UK,2023-04-23,SY-See @ Spring Invite UK,SCRAM,12,7,520.5112660164395,1.0,0,160.04,5,1,0,1.3599999999999999,5,1,0,1.5068997650978204
Spring Invite UK,2023-04-23,Spice,Brighton @ Spring Invite UK,15,1,600.0,1.0,1,805.8,14,1,0,11.68,14,1,0,12.352760361957383
Spring Invite UK,2023-04-23,Spice,SCRAM,15,6,600.0,1.0,0,490.1,9,1,0,6.26,9,1,0,6.378950577073102
Spring Invite UK,2023-04-23,Spice,SMOG Women @ Spring Invite UK,13,10,328.14240231865136,1.0,0,283.31,3,1,0,3.17,3,1,0,3.553680912018976
Toms Tourney,2023-05-05,Austria Women @ Toms Tourney,DESKEAGH @ Toms Tourney,13,12,125.0,1.0,0,-128.91000000000003,1,1,0,-1.2999999999999998,1,1,0,-1.4541685910387923
Toms Tourney,2023-05-05,Austria Women @ Toms Tourney,GB U24 Women @ Toms Tourney,11,8,365.60925011032475,1.0,0,126.18,3,1,0,1.2600000000000002,3,1,0,1.7817977963127092
Toms Tourney,2023-05-05,Austria Women @ Toms Tourney,Spain Women @ Toms Tourney,12,8,441.15462425988915,1.0,0,255.47999999999996,4,1,0,2.1200000000000006,4,1,0,2.654506653501347
Toms Tourney,2023-05-05,Belgian Women @ Toms Tourney,Austria Women @ Toms Tourney,12,8,441.15462425988915,1.0,0,402.12,4,1,0,5.74,4,1,0,5.865254615206194
Toms Tourney,2023-05-05,Belgian Women @ Toms Tourney,Czech Women @ Toms Tourney,14,10,398.70186369942724,1.0,0,160.29999999999998,4,1,0,1.32,4,1,0,1.3337185291310725
Toms Tourney,2023-05-05,Belgian Women @ Toms Tourney,German masters @ Toms Tourney,15,3,600.0,1.0,0,707.6299999999999,12,1,0,10.77,12,1,0,10.606424812201144
Toms Tourney,2023-05-05,Belgian Women @ Toms Tourney,LMU @ Toms Tourney,14,8,536.0348119187572,1.0,0,137.39999999999998,6,1,0,1.52,6,1,0,1.8121064835189706
Toms Tourney,2023-05-05,Bordeaux Ultimate @ Toms Tourney,Family Ultimate @ Toms Tourney,14,11,313.3379659704299,1.0,0,313.34,3,1,0,3.0,3,1,0,2.999531218569235
Toms Tourney,2023-05-05,Czech Women @ Toms Tourney,Crazy Dogs,15,1,600.0,1.0,0,747.34,14,1,0,13.23,14,1,0,13.189420860339744
Toms Tourney,2023-05-05,Czech Women @ Toms Tourney,DESKEAGH @ Toms Tourney,15,4,600.0,1.0,0,112.91,11,1,0,3.12,11,1,0,3.3419937809846267
Toms Tourney,2023-05-05,Czech Women @ Toms Tourney,Germany U24 @ Toms Tourney,11,10,125.0,1.0,0,64.53,1,1,0,1.8299999999999998,1,1,0,1.7647888819095954
Toms Tourney,2023-05-05,DESKEAGH @ Toms Tourney,Austria Women @ Toms Tourney,14,10,398.70186369942724,1.0,0,128.91000000000003,4,1,0,1.2999999999999998,4,1,0,1.454168591038794
Toms Tourney,2023-05-05,DESKEAGH @ Toms Tourney,NL Women @ Toms Tourney,12,10,238.1225775586291,1.0,0,-103.03999999999999,2,1,0,-1.57,2,1,0,-1.5440119092503242
Toms Tourney,2023-05-05,DESKEAGH @ Toms Tourney,Panthers Wroclaw - Women,11,10,125.0,1.0,0,-9.949999999999989,1,1,0,-0.3699999999999999,1,1,0,-0.4131454791381497
Toms Tourney,2023-05-05,France Women @ Toms Tourney,Austria Women @ Toms Tourney,13,10,328.14240231865136,1.0,0,420.62,3,1,0,5.52,3,1,0,5.726806219072916
Toms Tourney,2023-05-05,France Women @ Toms Tourney,Belgian Women @ Toms Tourney,13,9,418.5661446562001,1.0,0,18.5,4,1,0,-0.21999999999999975,4,1,0,-0.16274361385509195
Toms Tourney,2023-05-05,France Women @ Toms Tourney,Czech Women @ Toms Tourney,12,8,441.15462425988915,1.0,0,178.79999999999998,4,1,0,1.1000000000000003,4,1,0,1.172105628245557
Toms Tourney,2023-05-05,France Women @ Toms Tourney,German masters @ Toms Tourney,15,4,600.0,1.0,0,726.1299999999999,11,1,0,10.55,11,1,0,10.524421185375989
Toms Tourney,2023-05-05,France Women @ Toms Tourney,Shout,12,11,125.0,1.0,0,-281.67,1,1,0,-2.59,1,1,0,-3.071459639475
Toms Tourney,2023-05-05,GB U24 Women @ Toms Tourney,Crazy Dogs,15,4,600.0,1.0,0,379.34000000000003,11,1,0,7.55,11,1,0,10.955060477000881
Toms Tourney,2023-05-05,GB U24 Women @ Toms Tourney,Spain Women @ Toms Tourney,11,7,466.8933257329327,0.9733285267845752,0,129.29999999999995,4,1,0,0.8600000000000003,4,1,0,0.8914482649618822
Toms Tourney,2023-05-05,GB U24 Women @ Toms Tourney,Spain Women @ Toms Tourney,11,7,466.8933257329327,0.9733285267845752,0,129.29999999999995,4,1,0,0.8600000000000003,4,1,0,0.8914482649618822
Toms Tourney,2023-05-05,GB Women @ Toms Tourney,Austria Women @ Toms Tourney,13,7,557.5316737222639,1.0,0,607.11,6,1,0,6.93,6,1,0,6.964745393333281
Toms Tourney,2023-05-05,GB Women @ Toms Tourney,Belgian Women @ Toms Tourney,12,9,345.3654772346762,1.0,0,204.99,3,1,0,1.1900000000000004,3,1,0,1.3433908872050964
Toms Tourney,2023-05-05,GB Women @ Toms Tourney,DESKEAGH @ Toms Tourney,11,8,365.60925011032475,1.0,0,478.2,3,1,0,5.630000000000001,3,1,0,5.770315742598054
Toms Tourney,2023-05-05,GB Women @ Toms Tourney,DESKEAGH @ Toms Tourney,11,8,365.60925011032475,1.0,0,478.2,3,1,0,5.630000000000001,3,1,0,5.770315742598054
Toms Tourney,2023-05-05,GB Women @ Toms Tourney,France Women @ Toms Tourney,12,8,441.15462425988915,1.0,0,186.49,4,1,0,1.4100000000000001,4,1,0,1.5046724390199735
Toms Tourney,2023-05-05,GB Women @ Toms Tourney,NL Women @ Toms Tourney,13,11,228.8403622143806,1.0,0,375.15999999999997,2,1,0,4.0600000000000005,2,1,0,4.400554776194998
Toms Tourney,2023-05-05,GB Women @ Toms Tourney,Panthers Wroclaw - Women,15,5,600.0,1.0,0,468.25,10,1,0,5.260000000000001,10,1,0,5.414539836498054
Toms Tourney,2023-05-05,GB Women @ Toms Tourney,Shout,15,12,300.4922431832018,1.0,0,-95.18,3,1,0,-1.1799999999999997,3,1,0,-1.5996441810577657
Toms Tourney,2023-05-05,German masters @ Toms Tourney,Crazy Dogs,15,3,600.0,1.0,0,200.0100000000001,12,1,0,3.7800000000000002,12,1,0,7.844886332057719
Toms Tourney,2023-05-05,Germany U24 @ Toms Tourney,Crazy Dogs,15,6,600.0,1.0,0,682.8100000000001,9,1,0,11.4,9,1,0,12.742901778063509
Toms Tourney,2023-05-05,Germany U24 @ Toms Tourney,Crazy Dogs,15,6,600.0,1.0,0,682.8100000000001,9,1,0,11.4,9,1,0,12.742901778063509
Toms Tourney,2023-05-05,Germany U24 @ Toms Tourney,GB U24 Women @ Toms Tourney,15,6,600.0,1.0,0,303.47,9,1,0,3.85,9,1,0,4.710313880204964
Toms Tourney,2023-05-05,Germany U24 @ Toms Tourney,German masters @ Toms Tourney,15,7,600.0,1.0,0,482.79999999999995,8,1,0,7.619999999999999,8,1,0,8.814073809748422
Toms Tourney,2023-05-05,Helgtre @ Toms Tourney,AUC @ Toms Tourney,15,13,214.17926913507503,1.0,0,214.18,2,1,0,2.0,2,1,0,1.9995286300752646
Toms Tourney,2023-05-05,JinX,Austria Women @ Toms Tourney,14,6,600.0,1.0,0,343.90000000000003,8,1,0,3.8,8,1,0,4.164279684726392
Toms Tourney,2023-05-05,JinX,Austria Women @ Toms Tourney,14,6,600.0,1.0,0,343.90000000000003,8,1,0,3.8,8,1,0,4.164279684726392
Toms Tourney,2023-05-05,JinX,Czech Women @ Toms Tourney,10,9,125.0,1.0,0,102.08000000000001,1,1,0,-0.6199999999999999,1,1,0,-0.5809592468979563
Toms Tourney,2023-05-05,JinX,DESKEAGH @ Toms Tourney,15,8,564.8086448756737,1.0,0,214.99,7,1,0,2.5,7,1,0,2.785067340510331
Toms Tourney,2023-05-05,JinX,France Women @ Toms Tourney,12,11,125.0,1.0,0,-76.71999999999998,1,1,0,-1.7200000000000002,1,1,0,-1.747775364257091
Toms Tourney,2023-05-05,JinX,GB U24 Women @ Toms Tourney,13,10,328.14240231865136,1.0,0,470.08000000000004,3,1,0,5.0600000000000005,3,1,0,5.756251543456578
Toms Tourney,2023-05-05,JinX,GB Women @ Toms Tourney,12,10,238.1225775586291,1.0,0,-263.21,2,1,0,-3.1300000000000003,2,1,0,-3.214871959449848
Toms Tourney,2023-05-05,JinX,Spain Women @ Toms Tourney,15,12,300.4922431832018,1.0,0,599.38,3,1,0,5.92,3,1,0,6.499471406171658
Toms Tourney,2023-05-05,LMU @ Toms Tourney,Crazy Dogs,15,3,600.0,1.0,0,770.24,12,1,0,13.03,12,1,0,13.076524330428533
Toms Tourney,2023-05-05,LMU @ Toms Tourney,France Women @ Toms Tourney,12,10,238.1225775586291,1.0,0,-155.89999999999998,2,1,0,-1.3000000000000003,2,1,0,-1.6515275360379018
Toms Tourney,2023-05-05,LMU @ Toms Tourney,German masters @ Toms Tourney,15,2,600.0,1.0,0,570.2299999999999,13,1,0,9.25,13,1,0,9.615712638372457
Toms Tourney,2023-05-05,LMU @ Toms Tourney,Germany U24 @ Toms Tourney,14,13,125.0,1.0,0,87.42999999999999,1,1,0,1.63,1,1,0,1.2860846170299176
Toms Tourney,2023-05-05,LMU @ Toms Tourney,Panthers Wroclaw - Women,12,10,238.1225775586291,1.0,0,125.86,2,1,0,2.55,2,1,0,2.47905160831041
Toms Tourney,2023-05-05,LMU @ Toms Tourney,Spain Women @ Toms Tourney,15,9,515.4814780292847,1.0,0,520.1999999999999,6,1,0,6.34,6,1,0,6.578442521071022
Toms Tourney,2023-05-05,NL Women @ Toms Tourney,Crazy Dogs,15,4,600.0,1.0,0,737.47,11,1,0,11.68,11,1,0,12.721519046461587
Toms Tourney,2023-05-05,NL Women @ Toms Tourney,GB U24 Women @ Toms Tourney,14,8,536.0348119187572,1.0,0,358.13,6,1,0,4.13,6,1,0,4.641247468015539
Toms Tourney,2023-05-05,NL Women @ Toms Tourney,Germany U24 @ Toms Tourney,15,13,214.17926913507503,1.0,0,54.66,2,1,0,0.28,2,1,0,-0.07649933675189935
Toms Tourney,2023-05-05,NL Women @ Toms Tourney,Panthers Wroclaw - Women,12,11,125.0,1.0,0,93.09,1,1,0,1.2000000000000002,1,1,0,1.1340816854619113
Toms Tourney,2023-05-05,NL Women @ Toms Tourney,Panthers Wroclaw - Women,12,11,125.0,1.0,0,93.09,1,1,0,1.2000000000000002,1,1,0,1.1340816854619113
Toms Tourney,2023-05-05,NL Women @ Toms Tourney,Spain Women @ Toms Tourney,13,9,418.5661446562001,1.0,0,487.42999999999995,4,1,0,4.99,4,1,0,5.432794323651493
Toms Tourney,2023-05-05,Panthers Wroclaw - Women,GB U24 Women @ Toms Tourney,12,6,579.3107485100336,0.9733285267845752,0,265.04,6,1,0,2.9299999999999997,6,1,0,3.59117622290562
Toms Tourney,2023-05-05,Panthers Wroclaw - Women,German masters @ Toms Tourney,15,11,381.1647521399218,1.0,0,444.36999999999995,4,1,0,6.699999999999999,4,1,0,7.982360075446596
Toms Tourney,2023-05-05,Panthers Wroclaw - Women,Spain Women @ Toms Tourney,14,9,473.8676990361691,1.0,0,394.34,5,1,0,3.79,5,1,0,4.4197394951248015
Toms Tourney,2023-05-05,Reading Ultimate @ Toms Tourney,Vertigo @ Toms Tourney,15,5,600.0,1.0,0,600.0,10,1,0,10.0,10,1,0,9.999842029528253
Toms Tourney,2023-05-05,Shout,Belgian Women @ Toms Tourney,13,10,328.14240231865136,1.0,0,300.17,3,1,0,2.37,3,1,0,2.915192422827211
Toms Tourney,2023-05-05,Shout,Crazy Dogs,15,4,600.0,1.0,1,1207.81,11,1,0,16.92,11,1,0,13.950526722258871
Toms Tourney,2023-05-05,Shout,Czech Women @ Toms Tourney,14,10,398.70186369942724,1.0,0,460.47,4,1,0,3.6900000000000004,4,1,0,4.176736095526898
Toms Tourney,2023-05-05,Shout,Czech Women @ Toms Tourney,14,10,398.70186369942724,1.0,0,460.47,4,1,0,3.6900000000000004,4,1,0,4.176736095526898
Toms Tourney,2023-05-05,Shout,DESKEAGH @ Toms Tourney,15,10,453.6039151898044,1.0,0,573.38,5,1,0,6.8100000000000005,5,1,0,7.0795277414182145
Toms Tourney,2023-05-05,Shout,Germany U24 @ Toms Tourney,15,9,515.4814780292847,1.0,0,525.0,6,1,0,5.5200000000000005,6,1,0,5.75305347723917
Toms Tourney,2023-05-05,Shout,JinX,14,10,398.70186369942724,1.0,0,358.39,4,1,0,4.3100000000000005,4,1,0,4.706933399170776
Toms Tourney,2023-05-05,Spain Women @ Toms Tourney,German masters @ Toms Tourney,15,7,600.0,1.0,0,50.02999999999997,8,1,0,2.9099999999999993,8,1,0,4.225118217088184
Vienna Spring Break 2023,2023-05-20,3SB - Women,Chicas,14,8,536.0348119187572,1.0,0,281.96,6,1,0,4.58,6,1,0,5.560055247062067
Vienna Spring Break 2023,2023-05-20,AUT U24 Women @ Vienna Spring Break 2023,Mantis,11,10,125.0,1.0,0,164.33000000000004,1,1,0,1.0600000000000005,1,1,0,0.512800085090868
Vienna Spring Break 2023,2023-05-20,Catchup Women,Zürich Ultimate Swarm,15,8,564.8086448756737,1.0,0,565.53,7,1,0,6.390000000000001,7,1,0,7.625224771952372
Vienna Spring Break 2023,2023-05-20,Chicas,Zürich Ultimate Swarm,15,10,453.6039151898044,1.0,0,452.89,5,1,0,3.1000000000000005,5,1,0,4.105373884823553
Vienna Spring Break 2023,2023-05-20,East Block,3SB - Women,15,10,453.6039151898044,1.0,0,456.3,5,1,0,5.84,5,1,0,6.102993308420466
Vienna Spring Break 2023,2023-05-20,East Block,Catchup Women,15,9,515.4814780292847,1.0,0,625.62,6,1,0,7.13,6,1,0,7.410704746181274
Vienna Spring Break 2023,2023-05-20,East Block,Zürich Ultimate Swarm,15,4,600.0,1.0,1,1191.15,11,1,0,13.52,11,1,0,12.017707004976913
Vienna Spring Break 2023,2023-05-20,SCRAM,Mantis,15,10,453.6039151898044,1.0,0,414.26000000000005,5,1,0,4.430000000000001,5,1,0,5.170942307785587
Vienna Spring Break 2023,2023-05-20,SYC,AUT U24 Women @ Vienna Spring Break 2023,15,7,600.0,1.0,0,607.72,8,1,0,7.68,8,1,0,8.614343502370723
Vienna Spring Break 2023,2023-05-20,Swiss Women Ultimate @ Vienna Spring Break 2023,AUT U24 Women @ Vienna Spring Break 2023,15,3,600.0,1.0,0,836.9,12,1,0,14.17,12,1,0,12.227303594163054
Vienna Spring Break 2023,2023-05-20,Swiss Women Ultimate @ Vienna Spring Break 2023,SCRAM,15,1,600.0,1.0,0,586.97,14,1,0,10.8,14,1,0,10.101095984036608
Vienna Spring Break 2023,2023-05-20,Swiss Women Ultimate @ Vienna Spring Break 2023,SYC,15,5,600.0,1.0,0,229.18,10,1,0,6.49,10,1,0,6.792991840231409
Vienna Spring Break 2023,2023-05-20,Troubles Warsaw,3SB - Women,15,12,300.4922431832018,1.0,0,366.11,3,1,0,5.15,3,1,0,5.284930278060283
Vienna Spring Break 2023,2023-05-20,Troubles Warsaw,Catchup Women,15,14,125.0,1.0,0,535.4300000000001,1,1,0,6.4399999999999995,1,1,0,6.665394021059338
Vienna Spring Break 2023,2023-05-20,Troubles Warsaw,Chicas,15,3,600.0,1.0,0,648.0699999999999,12,1,0,9.73,12,1,0,9.592257789630619
Vienna Spring Break 2023,2023-05-20,box vienna,Mantis,15,6,600.0,1.0,1,860.33,9,1,0,9.510000000000002,9,1,0,9.565609027117443
Vienna Spring Break 2023,2023-05-20,box vienna,SCRAM,15,7,600.0,1.0,0,446.07,8,1,0,5.08,8,1,0,5.633007334078528
Vienna Spring Break 2023,2023-05-20,box vienna,SYC,15,13,214.17926913507503,1.0,0,88.28,2,1,0,0.7700000000000001,2,1,0,0.9915519507027017
Vienna Spring Break 2023,2023-05-21,3SB - Women,SCRAM,15,8,564.8086448756737,1.0,0,204.64,7,1,0,2.42,7,1,0,2.940442335609333
Vienna Spring Break 2023,2023-05-21,Chicas,AUT U24 Women @ Vienna Spring Break 2023,10,7,389.6652919127421,0.9459053029269173,0,172.61,3,1,0,1.21,3,1,0,2.007631437651831
Vienna Spring Break 2023,2023-05-21,East Block,Swiss Women Ultimate @ Vienna Spring Break 2023,14,12,220.95664314305532,1.0,0,73.97,2,1,0,-2.54,2,1,0,-2.7655105443698123
Vienna Spring Break 2023,2023-05-21,SYC,Catchup Women,10,8,262.66557693448596,0.9733285267845752,0,322.46999999999997,2,1,0,3.18,2,1,0,3.526768458972427
Vienna Spring Break 2023,2023-05-21,Troubles Warsaw,box vienna,15,4,600.0,1.0,0,124.68,11,1,0,2.4899999999999998,11,1,0,2.5526704878572524
Vienna Spring Break 2023,2023-05-21,box vienna,East Block,15,11,381.1647521399218,1.0,0,-214.87,4,1,0,-3.1799999999999997,4,1,0,-3.4700322282891634
Elite Invite,2023-05-29,Bristol,3SB - Women,15,9,515.4814780292847,1.0,0,316.99,6,1,0,4.21,6,1,0,4.454642398452126
Elite Invite,2023-05-29,Bristol,FABulous,15,4,600.0,1.0,0,278.36,11,1,0,4.56,11,1,0,4.626322080449199
Elite Invite,2023-05-29,Bristol,box vienna,13,12,125.0,1.0,0,75.56,1,1,0,1.5499999999999998,1,1,0,1.6426360514517064
Elite Invite,2023-05-29,FABulous,3SB - Women,15,8,564.8086448756737,1.0,0,38.629999999999995,7,1,0,-0.34999999999999987,7,1,0,-0.1889899987551189
Elite Invite,2023-05-29,JinX,3SB - Women,15,9,515.4814780292847,1.0,0,204.29000000000002,6,1,0,2.31,6,1,0,2.4659184001949335
Elite Invite,2023-05-29,JinX,Bristol,15,6,600.0,1.0,0,-112.7,9,1,0,-1.9,9,1,0,-2.0907994737194393
Elite Invite,2023-05-29,JinX,FABulous,15,6,600.0,1.0,0,165.66000000000003,9,1,0,2.66,9,1,0,2.649420754826192
Elite Invite,2023-05-29,JinX,Seagulls,12,8,441.15462425988915,1.0,0,-156.3,4,1,0,-2.22,4,1,0,-2.3716845105836395
Elite Invite,2023-05-29,JinX,YAKA,12,11,125.0,1.0,0,-434.57,1,1,0,-5.65,1,1,0,-5.8239058103821275
Elite Invite,2023-05-29,Seagulls,3SB - Women,12,6,579.3107485100336,0.9733285267845752,0,360.59000000000003,6,1,0,4.53,6,1,0,4.715045661961113
Elite Invite,2023-05-29,Seagulls,Bristol,13,7,557.5316737222639,1.0,0,43.599999999999994,6,1,0,0.3200000000000003,6,1,0,0.2872148914706525
Elite Invite,2023-05-29,Seagulls,box vienna,15,9,515.4814780292847,1.0,0,119.16,6,1,0,1.87,6,1,0,1.9258128169939326
Elite Invite,2023-05-29,Shout,3SB - Women,15,9,515.4814780292847,1.0,0,562.6800000000001,6,1,0,6.62,6,1,0,6.820982657577801
Elite Invite,2023-05-29,Shout,FABulous,15,6,600.0,1.0,0,524.05,9,1,0,6.97,9,1,0,6.970039056553642
Elite Invite,2023-05-29,Shout,Seagulls,15,8,564.8086448756737,1.0,0,202.09,7,1,0,2.09,7,1,0,2.45716076756381
Elite Invite,2023-05-29,Shout,Seagulls,15,13,214.17926913507503,1.0,0,202.09,2,1,0,2.09,2,1,0,2.45716076756381
Elite Invite,2023-05-29,Shout,box vienna,15,9,515.4814780292847,1.0,0,321.25,6,1,0,3.96,6,1,0,4.292692878871431
Elite Invite,2023-05-29,YAKA,Bristol,15,10,453.6039151898044,1.0,0,321.87,5,1,0,3.75,5,1,0,3.946694778576134
Elite Invite,2023-05-29,YAKA,FABulous,15,7,600.0,1.0,0,600.23,8,1,0,8.31,8,1,0,7.929537329454462
Elite Invite,2023-05-29,YAKA,JinX,15,5,600.0,1.0,0,434.57,10,1,0,5.65,10,1,0,5.823905810382129
Elite Invite,2023-05-29,YAKA,Shout,14,12,220.95664314305532,1.0,0,76.18,2,1,0,1.3399999999999999,2,1,0,1.2719382232305279
Elite Invite,2023-05-29,YAKA,box vienna,15,9,515.4814780292847,1.0,0,397.43,6,1,0,5.3,6,1,0,5.432794323651493
Elite Invite,2023-05-29,box vienna,3SB - Women,15,7,600.0,1.0,0,241.43,8,1,0,2.66,8,1,0,2.9065313477930133
Elite Invite,2023-05-29,box vienna,FABulous,13,9,418.5661446562001,1.0,0,202.8,4,1,0,3.01,4,1,0,3.0879824784856744
Windmill,2023-06-16,3SB - Women,Frizzly Bears Women,12,7,520.5112660164395,1.0,0,428.01000000000005,5,1,0,6.2,5,1,0,6.528074138630597
Windmill,2023-06-16,Austria Women @ Windmill,Iceni,13,8,496.1596377856195,1.0,0,208.18,5,1,0,2.9,5,1,0,2.7292685900512197
Windmill,2023-06-16,Austria Women @ Windmill,La SÃ©ptima @ Windmill,13,5,600.0,1.0,0,462.87,8,1,0,6.12,8,1,0,6.086712738741806
Windmill,2023-06-16,Austria Women @ Windmill,SYC,13,11,228.8403622143806,1.0,0,451.42,2,1,0,6.15,2,1,0,6.089844953062336
Windmill,2023-06-16,Belgium Women @ Windmill,Austria Women @ Windmill,13,11,228.8403622143806,1.0,0,-9.259999999999991,2,1,0,-0.2999999999999998,2,1,0,-0.2069868606409031
Windmill,2023-06-16,Belgium Women @ Windmill,Seagulls,14,10,398.70186369942724,1.0,0,234.72,4,1,0,3.21,4,1,0,3.272066514442752
Windmill,2023-06-16,Belgium Women @ Windmill,Spice,14,9,473.8676990361691,1.0,0,309.85,5,1,0,3.9000000000000004,5,1,0,4.253412117686651
Windmill,2023-06-16,Bristol,Frizzly Bears Women,15,5,600.0,1.0,1,745.0,10,1,0,10.41,10,1,0,9.72571208733213
Windmill,2023-06-16,Bristol,Spain Women @ Windmill,15,6,600.0,1.0,0,127.25,9,1,0,1.96,9,1,0,2.2743272798459664
Windmill,2023-06-16,Czech Republic Women @ Windmill,Belgium Women @ Windmill,15,11,381.1647521399218,1.0,0,153.38,4,1,0,1.9999999999999991,4,1,0,2.3519365472136258
Windmill,2023-06-16,Czech Republic Women @ Windmill,France Women @ Windmill,12,10,238.1225775586291,1.0,0,-132.53999999999996,2,1,0,-1.67,2,1,0,-1.9132716141841044
Windmill,2023-06-16,Czech Republic Women @ Windmill,Spain Women @ Windmill,15,10,453.6039151898044,1.0,0,558.95,5,1,0,7.489999999999999,5,1,0,7.527459767720252
Windmill,2023-06-16,Electroclit @ Windmill,3SB - Women,15,10,453.6039151898044,1.0,0,-16.359999999999985,5,1,0,-0.71,5,1,0,-0.6431055224526219
Windmill,2023-06-16,Electroclit @ Windmill,JinX,15,11,381.1647521399218,1.0,0,-220.64999999999998,4,1,0,-3.02,4,1,0,-3.0872642565460424
Windmill,2023-06-16,France Women @ Windmill,Bristol,13,7,557.5316737222639,1.0,0,564.24,6,1,0,7.199999999999999,6,1,0,7.248567732687576
Windmill,2023-06-16,France Women @ Windmill,Poland Women @ Windmill,14,5,600.0,1.0,0,777.0699999999999,9,1,0,9.85,9,1,0,9.412666701792428
Windmill,2023-06-16,Germany Women @ Windmill,France Women @ Windmill,13,12,125.0,1.0,0,275.37,1,1,0,3.370000000000001,1,1,0,3.229895094986748
Windmill,2023-06-16,Germany Women @ Windmill,Ireland Women @ Windmill,15,4,600.0,1.0,0,679.14,11,1,0,9.49,11,1,0,8.8649859820612
Windmill,2023-06-16,Germany Women @ Windmill,Mermaid lumberjacks @ Windmill,15,7,600.0,1.0,0,360.39,8,1,0,4.130000000000001,8,1,0,4.160126163428362
Windmill,2023-06-16,Germany Women @ Windmill,Switzerland Women @ Windmill,15,7,600.0,1.0,0,523.3599999999999,8,1,0,6.75,8,1,0,6.802527330855757
Windmill,2023-06-16,Iceni,Ireland Women @ Windmill,11,11,0.0,1.0,0,-81.07,0,1,0,-0.1499999999999999,0,1,0,0.058499703406804215
Windmill,2023-06-16,Ireland Women @ Windmill,Electroclit @ Windmill,15,9,515.4814780292847,1.0,0,493.81999999999994,6,1,0,6.0,6,1,0,5.901427975509634
Windmill,2023-06-16,Ireland Women @ Windmill,JinX,15,6,600.0,1.0,0,273.16999999999996,9,1,0,2.98,9,1,0,3.0621171981307604
Windmill,2023-06-16,JinX,Frizzly Bears Women,15,10,453.6039151898044,1.0,0,632.3000000000001,5,1,0,8.51,5,1,0,8.393478398503131
Windmill,2023-06-16,La SÃ©ptima @ Windmill,Electroclit @ Windmill,15,11,381.1647521399218,1.0,0,158.05999999999997,4,1,0,2.63,4,1,0,2.572329508048579
Windmill,2023-06-16,La SÃ©ptima @ Windmill,Poland Women @ Windmill,12,10,238.1225775586291,1.0,0,37.54,2,1,0,0.36,2,1,0,0.512800085090868
Windmill,2023-06-16,Mermaid lumberjacks @ Windmill,Czech Republic Women @ Windmill,14,10,398.70186369942724,1.0,0,47.51999999999998,4,1,0,0.9100000000000001,4,1,0,0.931798649858349
Windmill,2023-06-16,Mermaid lumberjacks @ Windmill,Iceni,12,12,0.0,1.0,0,399.82,0,1,0,5.51,0,1,0,5.5768679041410465
Windmill,2023-06-16,Mermaid lumberjacks @ Windmill,SYC,15,3,600.0,1.0,0,643.06,12,1,0,8.76,12,1,0,8.445875251918832
Windmill,2023-06-16,Poland Women @ Windmill,Frizzly Bears Women,15,5,600.0,1.0,0,532.1700000000001,10,1,0,7.76,10,1,0,7.646339439336103
Windmill,2023-06-16,SYC,La SÃ©ptima @ Windmill,13,9,418.5661446562001,1.0,0,11.45,4,1,0,-0.030000000000000027,4,1,0,-0.0037499999218759683
Windmill,2023-06-16,Seagulls,3SB - Women,14,12,220.95664314305532,1.0,0,360.59000000000003,2,1,0,4.53,2,1,0,4.715045661961113
Windmill,2023-06-16,Seagulls,Iceni,13,12,125.0,1.0,0,-35.79999999999998,1,1,0,-0.6099999999999999,1,1,0,-0.7718177693943087
Windmill,2023-06-16,Seagulls,SYC,12,9,345.3654772346762,1.0,0,207.44,3,1,0,2.64,3,1,0,2.892813862017327
Windmill,2023-06-16,Spain Women @ Windmill,3SB - Women,14,11,313.3379659704299,1.0,0,189.74,3,1,0,2.25,3,1,0,2.2831195763454666
Windmill,2023-06-16,Spice,Poland Women @ Windmill,15,7,600.0,1.0,0,181.3,8,1,0,2.28,8,1,0,2.3709532544279455
Windmill,2023-06-16,Spice,Spain Women @ Windmill,15,8,564.8086448756737,1.0,0,95.72,7,1,0,1.5899999999999999,7,1,0,1.526200435531699
Windmill,2023-06-16,Switzerland Women @ Windmill,Bristol,13,8,496.1596377856195,1.0,0,316.25,5,1,0,3.8200000000000003,5,1,0,3.770203185041055
Windmill,2023-06-16,Switzerland Women @ Windmill,JinX,15,5,600.0,1.0,0,428.95,10,1,0,5.720000000000001,10,1,0,5.662616322778998
Windmill,2023-06-16,Switzerland Women @ Windmill,Spice,14,11,313.3379659704299,1.0,0,347.78,3,1,0,4.19,3,1,0,4.473099042141609
Windmill,2023-06-17,3SB - Women,JinX,15,10,453.6039151898044,1.0,0,-204.29000000000002,5,1,0,-2.31,5,1,0,-2.4659184001949352
Windmill,2023-06-17,3SB - Women,Poland Women @ Windmill,15,11,381.1647521399218,1.0,0,-104.16,4,1,0,-1.56,4,1,0,-1.4370788131127892
Windmill,2023-06-17,Austria Women @ Windmill,Ireland Women @ Windmill,12,12,0.0,1.0,0,127.11000000000001,0,1,0,2.75,0,1,0,2.7857914784535147
Windmill,2023-06-17,Belgium Women @ Windmill,Austria Women @ Windmill,14,13,125.0,1.0,0,-9.259999999999991,1,1,0,-0.2999999999999998,1,1,0,-0.2069868606409031
Windmill,2023-06-17,Bristol,Seagulls,9,9,0.0,0.9733285267845752,0,-43.599999999999994,0,1,0,-0.3200000000000003,0,1,0,-0.2872148914706525
Windmill,2023-06-17,Czech Republic Women @ Windmill,Switzerland Women @ Windmill,14,10,398.70186369942724,1.0,0,115.44999999999999,4,1,0,1.709999999999999,4,1,0,2.1172682311367836
Windmill,2023-06-17,Electroclit @ Windmill,Frizzly Bears Women,14,10,398.70186369942724,1.0,0,411.6500000000001,4,1,0,5.49,4,1,0,5.9968631672844595
Windmill,2023-06-17,France Women @ Windmill,Czech Republic Women @ Windmill,15,13,214.17926913507503,1.0,0,132.53999999999996,2,1,0,1.67,2,1,0,1.9132716141841009
Windmill,2023-06-17,France Women @ Windmill,Mermaid lumberjacks @ Windmill,12,8,441.15462425988915,1.0,0,85.01999999999998,4,1,0,0.7599999999999998,4,1,0,0.9893117602595627
Windmill,2023-06-17,France Women @ Windmill,Spice,15,9,515.4814780292847,1.0,0,595.77,6,1,0,7.569999999999999,6,1,0,7.817061465337961
Windmill,2023-06-17,Germany Women @ Windmill,Austria Women @ Windmill,14,8,536.0348119187572,1.0,0,552.03,6,1,0,6.74,6,1,0,6.82871425302422
Windmill,2023-06-17,Germany Women @ Windmill,Czech Republic Women @ Windmill,12,9,345.3654772346762,1.0,0,407.90999999999997,3,1,0,5.040000000000001,3,1,0,5.005684654591835
Windmill,2023-06-17,Germany Women @ Windmill,Mermaid lumberjacks @ Windmill,14,10,398.70186369942724,1.0,0,360.39,4,1,0,4.130000000000001,4,1,0,4.160126163428362
Windmill,2023-06-17,Iceni,Bristol,15,9,515.4814780292847,1.0,0,79.39999999999998,6,1,0,0.9300000000000002,6,1,0,1.0579902932942424
Windmill,2023-06-17,Iceni,SYC,10,10,0.0,1.0,0,243.23999999999998,0,1,0,3.25,0,1,0,3.628623986934226
Windmill,2023-06-17,Ireland Women @ Windmill,Bristol,11,8,365.60925011032475,1.0,0,160.46999999999997,3,1,0,1.08,3,1,0,0.9997656014916387
Windmill,2023-06-17,La SÃ©ptima @ Windmill,3SB - Women,14,11,313.3379659704299,1.0,0,141.7,3,1,0,1.92,3,1,0,1.9435133810593221
Windmill,2023-06-17,La SÃ©ptima @ Windmill,Frizzly Bears Women,15,5,600.0,1.0,0,569.71,10,1,0,8.120000000000001,10,1,0,8.019386792961104
Windmill,2023-06-17,La SÃ©ptima @ Windmill,Spain Women @ Windmill,10,9,125.0,1.0,0,-48.04,1,1,0,-0.32999999999999996,1,1,0,-0.3464383811971281
Windmill,2023-06-17,Mermaid lumberjacks @ Windmill,Belgium Women @ Windmill,12,7,520.5112660164395,1.0,0,200.89999999999998,5,1,0,2.9099999999999993,5,1,0,3.252059683369218
Windmill,2023-06-17,Poland Women @ Windmill,JinX,15,8,564.8086448756737,1.0,0,-100.13,7,1,0,-0.75,7,1,0,-1.0453029651719152
Windmill,2023-06-17,SYC,Electroclit @ Windmill,11,8,365.60925011032475,1.0,0,169.51,3,1,0,2.6,3,1,0,2.5686896333934257
Windmill,2023-06-17,SYC,Poland Women @ Windmill,11,9,249.2068104043629,1.0,0,48.989999999999995,2,1,0,0.32999999999999996,2,1,0,0.5090544358882028
Windmill,2023-06-17,Seagulls,Electroclit @ Windmill,15,4,600.0,1.0,0,376.95,11,1,0,5.24,11,1,0,5.286900869020705
Windmill,2023-06-17,Seagulls,Ireland Women @ Windmill,15,6,600.0,1.0,0,-116.86999999999998,9,1,0,-0.7599999999999998,9,1,0,-0.7134612373974356
Windmill,2023-06-17,Spain Women @ Windmill,Frizzly Bears Women,15,6,600.0,1.0,0,617.75,9,1,0,8.45,9,1,0,8.263786749516072
Windmill,2023-06-17,Spain Women @ Windmill,JinX,15,10,453.6039151898044,1.0,0,-14.550000000000004,5,1,0,-0.06000000000000005,5,1,0,-0.1874902349853116
Windmill,2023-06-17,Spice,Iceni,13,8,496.1596377856195,1.0,0,-110.92999999999998,5,1,0,-1.3000000000000003,5,1,0,-1.8113674248217677
Windmill,2023-06-17,Switzerland Women @ Windmill,Belgium Women @ Windmill,10,10,0.0,1.0,0,37.93000000000001,0,1,0,0.29000000000000004,0,1,0,0.23997952209693452
Windmill,2023-06-17,Switzerland Women @ Windmill,Spice,12,10,238.1225775586291,1.0,0,347.78,2,1,0,4.19,2,1,0,4.473099042141609
Windmill,2023-06-18,Austria Women @ Windmill,Spice,15,5,600.0,1.0,0,319.11,10,1,0,4.2,10,1,0,4.4430139500907195
Windmill,2023-06-18,Bristol,JinX,15,7,600.0,1.0,0,112.7,8,1,0,1.9,8,1,0,2.090799473719443
Windmill,2023-06-18,Germany Women @ Windmill,France Women @ Windmill,13,11,228.8403622143806,1.0,0,275.37,2,1,0,3.370000000000001,2,1,0,3.229895094986748
Windmill,2023-06-18,Ireland Women @ Windmill,3SB - Women,15,9,515.4814780292847,1.0,0,477.46,6,1,0,5.29,6,1,0,5.3485402252013365
Windmill,2023-06-18,Mermaid lumberjacks @ Windmill,Czech Republic Women @ Windmill,15,10,453.6039151898044,1.0,0,47.51999999999998,5,1,0,0.9100000000000001,5,1,0,0.931798649858349
Windmill,2023-06-18,Poland Women @ Windmill,Electroclit @ Windmill,15,9,515.4814780292847,1.0,0,120.51999999999998,6,1,0,2.27,6,1,0,2.071674877410725
Windmill,2023-06-18,SYC,Frizzly Bears Women,15,5,600.0,1.0,0,581.1600000000001,10,1,0,8.09,10,1,0,8.01670827775833
Windmill,2023-06-18,Seagulls,La SÃ©ptima @ Windmill,10,6,496.1596377856195,0.9176629354822471,0,218.89000000000001,4,1,0,2.6100000000000003,4,1,0,2.8892031608751196
Windmill,2023-06-18,Spain Women @ Windmill,Iceni,13,11,228.8403622143806,1.0,0,-206.64999999999998,2,1,0,-2.89,2,1,0,-3.297057866455967
Windmill,2023-06-18,Switzerland Women @ Windmill,Belgium Women @ Windmill,13,11,228.8403622143806,1.0,0,37.93000000000001,2,1,0,0.29000000000000004,2,1,0,0.23997952209693452
London Invite,2023-06-23,AUSU24s @ London Invite,GB Women @ London Invite,13,12,125.0,1.0,0,-60.22000000000003,1,1,0,-0.8999999999999995,1,1,0,-0.918349996526695
London Invite,2023-06-23,AUSU24s @ London Invite,GBWU24 @ London Invite,11,8,365.60925011032475,1.0,0,338.43,3,1,0,3.1800000000000006,3,1,0,3.192682597348117
London Invite,2023-06-23,AUSU24s @ London Invite,GBWU24 @ London Invite,7,3,600.0,0.7254762501100116,0,338.43,4,1,0,3.1800000000000006,4,1,0,3.192682597348117
London Invite,2023-06-23,GB Masters Women @ London Invite,AUSU24s @ London Invite,13,11,228.8403622143806,1.0,0,-98.18,2,1,0,-0.3799999999999999,2,1,0,-0.3726732917769393
London Invite,2023-06-23,GB Masters Women @ London Invite,GBWU24 @ London Invite,15,7,600.0,1.0,0,240.25,8,1,0,2.8000000000000007,8,1,0,2.835001138509476
London Invite,2023-06-23,GB Women @ London Invite,YAKA,15,10,453.6039151898044,1.0,0,-113.88999999999999,5,1,0,-0.9500000000000002,5,1,0,-0.9601852871149106
London Invite,2023-06-23,GB Womens @ London Invite,GB Masters Women @ London Invite,12,10,238.1225775586291,1.0,0,238.12,2,1,0,2.0,2,1,0,2.000265298115547
London Invite,2023-06-23,GBWU24 @ London Invite,GB Masters Women @ London Invite,7,4,496.1596377856195,0.7608859102526822,0,-240.25,3,1,0,-2.8000000000000007,3,1,0,-2.8350011385094778
London Invite,2023-06-23,YAKA,AUSU24s @ London Invite,11,9,249.2068104043629,1.0,0,174.11,2,1,0,1.8499999999999996,2,1,0,1.8712019504271247
London Invite,2023-06-23,YAKA,GB Masters Women @ London Invite,14,10,398.70186369942724,1.0,0,272.29,4,1,0,2.2299999999999995,4,1,0,2.236942242468132
London Invite,2023-06-23,YAKA,GB Women @ London Invite,13,8,496.1596377856195,1.0,0,113.88999999999999,5,1,0,0.9500000000000002,5,1,0,0.9601852871149106
London Invite,2023-06-23,YAKA,GBWU24 @ London Invite,13,8,496.1596377856195,1.0,0,512.54,5,1,0,5.03,5,1,0,4.9329070114341675
EUCR Gent,2023-08-07,FABulous,Wuf.,15,12,300.4922431832018,1.0,0,131.91,3,1,0,1.2100000000000002,3,1,0,1.2108595366719435
EUCR Gent,2023-08-07,Heidees Frauen,FABulous,15,11,381.1647521399218,1.0,0,419.39,4,1,0,5.13,4,1,0,5.23296325443129
EUCR Gent,2023-08-07,Heidees Frauen,FABulous,13,11,228.8403622143806,1.0,0,419.39,2,1,0,5.13,2,1,0,5.23296325443129
EUCR Gent,2023-08-07,Heidees Frauen,Lillipuc,11,5,600.0,0.9176629354822471,0,521.23,6,1,0,5.32,6,1,0,5.401489612893823
EUCR Gent,2023-08-07,Heidees Frauen,Seagulls,15,9,515.4814780292847,1.0,0,97.42999999999998,6,1,0,0.25,6,1,0,0.39291010104401636
EUCR Gent,2023-08-07,Jetset LUV,Lillipuc,15,11,381.1647521399218,1.0,0,440.33000000000004,4,1,0,4.640000000000001,4,1,0,4.812825813598188
EUCR Gent,2023-08-07,Jetset LUV,Seagulls,14,11,313.3379659704299,1.0,0,16.53,3,1,0,-0.43000000000000016,3,1,0,-0.2729698611532694
EUCR Gent,2023-08-07,Jetset LUV,Seagulls,13,8,496.1596377856195,1.0,0,16.53,5,1,0,-0.43000000000000016,5,1,0,-0.2729698611532694
EUCR Gent,2023-08-07,Jetset LUV,Wuf.,14,12,220.95664314305532,1.0,0,470.4,2,1,0,5.66,2,1,0,5.7075748510116995
EUCR Gent,2023-08-07,Lillipuc,Wuf.,9,8,125.0,0.9459053029269173,0,30.069999999999993,1,1,0,1.02,1,1,0,1.0191772825626835
EUCR Gent,2023-08-07,Mooncup,FABulous,14,7,582.8868714046324,1.0,0,708.3900000000001,7,1,0,8.17,7,1,0,7.800659300962163
EUCR Gent,2023-08-07,Mooncup,Heidees Frauen,15,13,214.17926913507503,1.0,0,289.00000000000006,2,1,0,3.04,2,1,0,3.136786719476355
EUCR Gent,2023-08-07,Mooncup,Seagulls,13,7,557.5316737222639,1.0,0,386.43000000000006,6,1,0,3.29,6,1,0,3.5104676459954156
EUCR Gent,2023-08-07,Mooncup,Tequila Boom Boom,12,8,441.15462425988915,1.0,0,396.53000000000003,4,1,0,4.25,4,1,0,4.371748154952019
EUCR Gent,2023-08-07,Mooncup,Tequila Boom Boom,15,11,381.1647521399218,1.0,0,396.53000000000003,4,1,0,4.25,4,1,0,4.371748154952019
EUCR Gent,2023-08-07,Seagulls,Lillipuc,12,9,345.3654772346762,1.0,0,423.8,3,1,0,5.07,3,1,0,5.056272517638909
EUCR Gent,2023-08-07,Seagulls,Wuf.,15,5,600.0,1.0,0,453.87,10,1,0,6.09,10,1,0,5.939417652442202
EUCR Gent,2023-08-07,Tequila Boom Boom,FABulous,14,11,313.3379659704299,1.0,0,311.86,3,1,0,3.92,3,1,0,4.041462461374753
EUCR Gent,2023-08-07,Tequila Boom Boom,Heidees Frauen,13,11,228.8403622143806,1.0,0,-107.52999999999997,2,1,0,-1.2100000000000004,2,1,0,-1.3151147048913838
EUCR Gent,2023-08-07,Tequila Boom Boom,Jetset LUV,12,8,441.15462425988915,1.0,0,-26.629999999999995,4,1,0,-0.5300000000000002,4,1,0,-0.6520887468996683
EUCR Gent,2023-08-07,Wuf.,Lillipuc,11,10,125.0,1.0,0,-30.069999999999993,1,1,0,-1.02,1,1,0,-1.0191772825626835
EUCR Warsaw,2023-08-27,3SB - Women,Panthers Wroclaw - Women,15,11,381.1647521399218,1.0,0,0.75,4,1,0,-0.17999999999999994,4,1,0,-0.08399912193101677
EUCR Warsaw,2023-08-27,East Block,3SB - Women,15,5,600.0,1.0,0,456.3,10,1,0,5.84,10,1,0,6.102993308420466
EUCR Warsaw,2023-08-27,East Block,Panthers Wroclaw - Women,15,11,381.1647521399218,1.0,0,457.05,4,1,0,5.66,4,1,0,6.032739342800859
EUCR Warsaw,2023-08-27,East Block,Troubles Warsaw,15,12,300.4922431832018,1.0,0,90.19,3,1,0,0.69,3,1,0,0.9549566824867259
EUCR Warsaw,2023-08-27,East Block,Troubles Warsaw,15,13,214.17926913507503,1.0,0,90.19,2,1,0,0.69,2,1,0,0.9549566824867259
EUCR Warsaw,2023-08-27,East Block,box vienna,12,10,238.1225775586291,1.0,0,214.87,2,1,0,3.1799999999999997,2,1,0,3.4700322282891634
EUCR Warsaw,2023-08-27,Panthers Wroclaw - Women,3SB - Women,14,8,536.0348119187572,1.0,0,-0.75,6,1,0,0.17999999999999994,6,1,0,0.083999121931015
EUCR Warsaw,2023-08-27,Troubles Warsaw,3SB - Women,15,10,453.6039151898044,1.0,0,366.11,5,1,0,5.15,5,1,0,5.284930278060283
EUCR Warsaw,2023-08-27,Troubles Warsaw,Panthers Wroclaw - Women,14,9,473.8676990361691,1.0,0,366.86,5,1,0,4.97,5,1,0,5.211212983635644
EUCR Warsaw,2023-08-27,Troubles Warsaw,box vienna,14,11,313.3379659704299,1.0,0,124.68,3,1,0,2.4899999999999998,3,1,0,2.5526704878572524
EUCR Warsaw,2023-08-27,box vienna,3SB - Women,13,11,228.8403622143806,1.0,0,241.43,2,1,0,2.66,2,1,0,2.9065313477930133
EUCR Warsaw,2023-08-27,box vienna,Panthers Wroclaw - Women,15,9,515.4814780292847,1.0,0,242.18,6,1,0,2.4800000000000004,6,1,0,2.825598264719936
UK Nationals,2023-08-27,Bristol,Chameleons,13,2,600.0,1.0,1,1295.39,11,1,0,17.46,11,1,0,14.393307370150819
UK Nationals,2023-08-27,Bristol,Flame,9,8,125.0,0.9459053029269173,0,292.87,1,1,0,3.84,1,1,0,3.452990795616632
UK Nationals,2023-08-27,Bristol,Gravity,11,7,466.8933257329327,0.9733285267845752,0,197.56,4,1,0,2.03,4,1,0,2.498014896281088
UK Nationals,2023-08-27,Bristol,LMU @ UK Nationals,10,7,389.6652919127421,0.9459053029269173,0,119.91,3,1,0,-0.1299999999999999,3,1,0,-0.8039787779075667
UK Nationals,2023-08-27,Bristol,Spice,10,9,125.0,1.0,0,31.53,1,1,0,0.3700000000000001,1,1,0,0.759849050080911
UK Nationals,2023-08-27,Flame,Chameleons,13,3,600.0,1.0,0,1002.52,10,1,0,13.62,10,1,0,14.04204585080014
UK Nationals,2023-08-27,Flame,Gravity,12,9,345.3654772346762,1.0,0,-95.31,3,1,0,-1.81,3,1,0,-0.9930453863237894
UK Nationals,2023-08-27,Flame,Horizon,13,10,328.14240231865136,1.0,0,397.26,3,1,0,4.26,3,1,0,6.582682098995377
UK Nationals,2023-08-27,Flame,SYC,11,8,365.60925011032475,1.0,0,-129.03,3,1,0,-1.52,3,1,0,-0.8727631099570736
UK Nationals,2023-08-27,Gravity,Horizon,13,5,600.0,1.0,0,492.57,8,1,0,6.069999999999999,8,1,0,7.361844564840251
UK Nationals,2023-08-27,Gravity,SCRAM,9,7,279.3368557106305,0.9176629354822471,0,324.07,2,1,0,4.6,2,1,0,4.867921725991113
UK Nationals,2023-08-27,Horizon,Chameleons,14,6,600.0,1.0,0,605.26,8,1,0,9.36,8,1,0,12.660568655226584
UK Nationals,2023-08-27,Iceni,Bristol,11,8,365.60925011032475,1.0,0,79.39999999999998,3,1,0,0.9300000000000002,3,1,0,1.0579902932942424
UK Nationals,2023-08-27,Iceni,Bristol,13,10,328.14240231865136,1.0,0,79.39999999999998,3,1,0,0.9300000000000002,3,1,0,1.0579902932942424
UK Nationals,2023-08-27,Iceni,Chameleons,13,1,600.0,1.0,1,1374.79,12,1,0,18.39,12,1,0,14.47184454414251
UK Nationals,2023-08-27,Iceni,Flame,10,4,600.0,0.8583950752789521,0,372.27,6,1,0,4.7700000000000005,6,1,0,4.438908392852138
UK Nationals,2023-08-27,Iceni,LMU @ UK Nationals,9,4,600.0,0.8271701918685112,0,199.30999999999997,5,1,0,0.8000000000000003,5,1,0,0.2549754378393825
UK Nationals,2023-08-27,Iceni,LMU @ UK Nationals,11,8,365.60925011032475,1.0,0,199.30999999999997,3,1,0,0.8000000000000003,3,1,0,0.2549754378393825
UK Nationals,2023-08-27,LMU @ UK Nationals,Chameleons,13,0,600.0,1.0,0,1175.48,13,1,0,17.59,13,1,0,14.453910991691629
UK Nationals,2023-08-27,LMU @ UK Nationals,Flame,13,3,600.0,1.0,0,172.96,10,1,0,3.9699999999999998,10,1,0,4.205085706269092
UK Nationals,2023-08-27,LMU @ UK Nationals,SYC,10,8,262.66557693448596,0.9733285267845752,0,43.93000000000001,2,1,0,2.4499999999999997,2,1,0,3.38757842197181
UK Nationals,2023-08-27,LMU @ UK Nationals,Spice,15,6,600.0,1.0,0,-88.38,9,1,0,0.5,9,1,0,1.5595933413756633
UK Nationals,2023-08-27,SCRAM,Chameleons,15,7,600.0,1.0,0,773.76,8,1,0,10.829999999999998,8,1,0,13.391670884796195
UK Nationals,2023-08-27,SCRAM,Gravity,15,9,515.4814780292847,1.0,0,-324.07,6,1,0,-4.6,6,1,0,-4.867921725991115
UK Nationals,2023-08-27,SCRAM,Horizon,13,5,600.0,1.0,0,168.5,8,1,0,1.4699999999999998,8,1,0,2.9663956057530108
UK Nationals,2023-08-27,SYC,Gravity,10,6,496.1596377856195,0.9176629354822471,0,33.72,4,1,0,-0.29000000000000004,4,1,0,-0.12074739176698479
UK Nationals,2023-08-27,SYC,Horizon,9,6,418.5661446562001,0.8885233166386386,0,526.29,3,1,0,5.779999999999999,3,1,0,7.269818563198566
UK Nationals,2023-08-27,SYC,SCRAM,9,7,279.3368557106305,0.9176629354822471,0,357.78999999999996,2,1,0,4.31,2,1,0,4.759608310684868
UK Nationals,2023-08-27,SYC,SCRAM,15,8,564.8086448756737,1.0,0,357.78999999999996,7,1,0,4.31,7,1,0,4.759608310684868
UK Nationals,2023-08-27,Spice,Gravity,9,4,600.0,0.8271701918685112,0,166.03,5,1,0,1.6599999999999997,5,1,0,1.7529538760883199
UK Nationals,2023-08-27,Spice,Horizon,11,4,600.0,0.9176629354822471,1,658.6,7,1,0,7.7299999999999995,7,1,0,8.620373147430747
UK Nationals,2023-08-27,Spice,SCRAM,11,6,546.6949863040446,0.9459053029269173,0,490.1,5,1,0,6.26,5,1,0,6.378950577073102
UK Nationals,2023-08-27,Spice,SYC,9,3,600.0,0.8271701918685112,0,132.31,6,1,0,1.9499999999999997,6,1,0,1.8719402744988685
